买来玩lol和炫舞卡不卡？	画质不是太满意，有点卡	1
充电器是快充吗	不是	1
有用一年历史的人吗	我的还没有	1
运行还有刚买时流畅吗，	我前几天用的就是奇酷青春版，用了一年多，系统不卡顿，现在还是选择360的手机，就是因为感觉系统好用。因为屏幕摔坏了才换这款。	1
有机打税务发票吗，	可以保修	0
S7和C9哪个好	平常用于接打电话c9就可以了，玩游戏什么的还是s7	1
接口是哪个型号	43的	1
请问红米pro和红米4note哪个好用一些？	差不多的，可以去官方旗舰店看一下，这家店太坑	1
ios刚出的10.2.1版本，日版的i7能升级吗？	老板一直不让升级，升级到10.2卡贴估计不支持	1
是不是黄牛啊	其实也就3600多吧，炒的，等段时间就行了	0
手机发热厉害吗，	发热，无残影	1
会很费电吗？	还是17-50 恒定大光圈加os防抖	0
请问，现在不都是4G的手机卡了吗？	不影响信号质量	0
努比亚有几个按键？	电源键，音量键＋－	1
电信4G可以用联通4G吗	这个还不知道呢	0
电池能用几天！	到手后一直都在游戏，一天没问题   充电半小时轻松续航一天	1
请问亲们下水后还正常吗？	没问题，经常洗	1
连接wifi初始密码是多少	GR2的wifi打开就可以看到初始密码，手机或其他设备只需连接一次，以后都是默认的。	1
接口是哪个型号	什么接口？	0
请问这是组装机吗？	呵呵，问这种幼稚问题	0
翻新机吗？	原装机，有全国联保单和发票的，就是玩游戏有点卡，	1
请问电池的电能够用多久	还没测试，每个人使用方式不同的吧	0
适合女性用吗	我就是帮女同事买的，当时要800多，现在又降了不少	1
大家新机里的电池电量多少？	没电，自己充	1
我想问一下，难道那么多人家里面家具都是一样的吗？	我是真的买了，因为要返现50才拍的照片！别人的我不清楚，这个价位，简单办公应该还行！谁不想买？	0
不支持双4G双卡双待吗？	支持双卡4G	1
玩那些辣鸡游戏买个这本子的脑子没问题吗？	不就是个笔记本嘛	0
用着怎么样？	买回来没几天，用的很少，所以暂时还没发现什么	0
这个手机能打电话吗？	可以，感觉都还行，毕竟这个价位	1
送钢化膜和手机壳吗？	送的	1
和索尼a6300比哪个好	我也是个小白，没有玩过Sony。所以不知道谁好。	0
想看一下大家的订单，因为快过年了嘛，所以问一下几天能到，	我恨你说，我在天猫旗舰店首发当天买的亮黑色，等了五十四天，这家店买的粉色，十天，都不是过年买的，无法告诉你答案	0
信号好吗？	很好用，放心。我用了这么多手机还是金立好！	1
型号是BIN-TL10对吗？	移动定制只能用移动卡，选全网通，电信移动联通三种卡都可用	0
电脑有没有什么问题	偶尔运行速度慢	0
分辨率多少，	没有注意，不过效果还行	0
請問|尼康|d5200|拍風景和人物|配|35還是50好	不了解哦。我是7200	0
官配和套餐有什么不一样么？	是的，官配连个包都没有	0
卡不卡	卡	1
是不是全新的手机。	不是安，手机还行	0
是正品吗？	是全新的。电池耐用。个人观点。	0
低配版玩游戏卡吗？	我买的是高配	0
打电话有杂音吗	抱歉，这款电话不是电信款，退货了	0
我就想知道|通话声音清晰吗？	效果不错，暂时没有任何问题	1
高配4+32的好吗？	全新的，我买的3+32，很流畅	0
请问有正规发票吗	我的是纸的发票一起发过来的  小米max只特点就是屏幕大  这个看个人喜不喜欢的	1
自提有赠品吗？	没有，抠门	1
都搭配笔记本？	不知道呀	0
是不是问题特别多	做工渣，wifi  数据断流严重 建议不要买	1
机子怎么样|	买了韩版有点后悔，自带相机拍普通照片不能静音，声音很大，下载其它app拍照效果不如系统自带相机，价格也就差几百，算上保修和没有电信，真的觉得不划算。	1
充满电能玩多久游戏？	一上午吧 大概得 不过待机挺长的 待机的话基本不费电 但是 你要是玩儿王者的话 有个注意的 不能开王者时刻	1
这个可以每天随身带着吗。	重的 但是我这个女汉子表示无所谓	1
晚上玩手机屏幕是不是刺眼	还行可以调	1
这个有无锁的么	有的，有少数无锁。。。	1
会不会有不灵敏或是按不动的感觉？	不会啊，我小孩用还不错	1
开机后机身可用内存多少？	是全网通4G 内存有25G左右可用	1
女生买什么色好看	瞎黑也不错	1
请问有正规发票吗	没有，不好用，屏幕太大，不实用	1
用起来好用吗？	是正品吧，这个倒是没多大在意，就是偶尔会卡顿，像素不好，电池消耗快，不过屏幕蛮大的打游戏非常不错	1
能满足妹子的拍照像素需求吗？	自拍还是别的手机，这款手机相当实用	1
6x是不是声音小，	没发现什么问题，还好。	1
建议购买吗	我觉得还可以啊！个人适应，有的人可能不喜欢。	0
没玩过笔记本电脑，买回来会不会很难上手，	还好啦  就是W10呢系统不熟悉	1
用的怎么样。	不会啊，挺好的，建议买4G的	1
会不会很重？	会的，习惯就好	1
外壳是铁的还是塑料的？	是塑料的，上网很卡的，而且不是高清屏幕。	1
耗电量，和系统流畅度怎么样！	我就是作为主机使用的，耗电量如果不停地玩的话，4个小时左右电就完了，我是手机重度使用者，但我能接受这个耗电量，手机偶尔会卡就和其他安卓机一样，总的来说，我用了几个月了，我觉得还是很不错的	1
是真的港版吗|	是的	1
机子到底怎样？	不错，是正品，我买的是国行	1
待机如何？	是正品，相对z3，流畅发热少，照相很满意。	0
大家有出现过触屏不灵的情况吗？	暂时没有	1
是正品吗？	应该是的	1
美图好还是这个好？	这个毕竟是相机专业功能都会比手机强吧	1
有6G+128G配置的吗？	q5没有	1
内存什么的和介绍的一样的吗，	你猜。	0
还是二手的	是新机	1
我一直在纠结买x9还是r9，各位前辈用得怎么样，	r9s挺好的	1
玩一些大型网游，比如王者荣耀会很卡吗？	卡	1
可以发电吗？	这只是一个能接打电话的手机功能没有那么多，主要便宜，	1
买过的亲们，请问wifi信号好吗，	很好	1
如果要玩王者卡么？	我老公就是买来玩游戏	1
我想问下第一次充电要充多久	抗电能力挺强的，一天都不用充电	0
是塑料外壳吗？	是	1
上网可以几个小时呢？	不清楚，我只是拿来当备用机，连4g待机能有三四天吧。我一般也是三天才充电一次。	0
可以直播嘛	可以的	1
电脑有没有什么问题	还行，用得不错	1
耗电过分吗	还可以。一天一充吧。	1
卡不卡，	非常垃圾，介绍写那么好，后悔了就当大几百走路掉了了吧。	0
多少英寸	4	1
是原装正品吗？	也不是街机 谁有那耐心防它啊	0
希望你们能回答我，这个镜头有一点旧的成分吗？	新的，只是对焦有点漂	1
想看一下大家的订单，因为快过年了嘛，所以问一下几天能到，	我是30号下单，1月3号就到手了	1
想问的是，这会不会是翻新的	不是的	1
6x是不是声音小，	我也是买半月了用着挺好的	1
套餐几比较划算实用	都OK	1
这手机屏幕是多大的？	6.0的，你们都不看参数么	1
亲们是自带win10系统么还是？	是自带的的	1
确定只是拆封|未激活的机子嚒？	买了韩版有点后悔，自带相机拍普通照片不能静音，声音很大，下载其它app拍照效果不如系统自带相机，价格也就差几百，算上保修和没有电信，真的觉得不划算。	0
应该太贵了，倒单可能多？	我元旦前一天买的时候银64g5470	0
那个好	我身边的朋友都在用 r9plus，都说蛮好的。	0
用着手感怎么样	有送，是顺丰，挺好的，一直在用OPPO	1
还是只能用后面的那一个摄像头	送人的，没注意看	0
是华强北发的货。手机有没有问题啊？	官换 目前无问题	1
有指纹支付功能吗？	有的	1
手机一开始都没电吗？	这款手机不怎么样，上网慢	0
这机子和小米旗舰店的有什么区别	觉得没什么，我看旗舰店发货要等，我又要急用，所以就买这的，发的顺丰，买的人也多，	1
旗舰店都没有送，东西和旗舰店一样吗？	东西真的不错，用了三四个月了，一点毛病没有，就是配置方面不是很行，不过我要的是屏幕大，当备用机的	0
为啥有送那么多东西？	一样的，是正品	1
听说这个玩酷跑会卡|说是CPU很低|真的吗	反应很慢不是很好用	1
一般玩个游戏会卡吗？	不玩游戏，但是软件开多了就有时候会	0
送钢化膜吗|	自己贴	0
为啥我看了好多家电脑，总是没有全部都说好的，总是有几个说电脑卡？	开机速度挺快	0
可以打王者荣誉吗	不能	1
买到手之后保修期是一年的吗？	没太明白	0
中间的home键能按下去吗？	不能	1
日版好用吗，	日版性价比非常高！值得入手！加超雪卡贴都可以啊！不错	1
内存64GB的是麒麟多少的？	简介里面都有啊	0
二手95|98|充新|这些有什么区别？	冲印是最新的 跟新的一样	1
我想问下，怎么把后盖打开上电池？	你仔细看有个开后盖的小口，做的确实像一体机	1
这个手机是正品还是翻新机？	真看不出来，反正我的不是全新的	1
我看评论里面有人说拍了灰色发银色，买过的说说这家店怎么样？	我的一个礼拜就到货了	0
不是官换机和翻新机吧？	是官换机，没有激活的，用着不错	1
怎么样，	是的，用着和我在实体店买的一样	1
手机怎样？	还可以，跟实体店没区别喔	1
有一段时间不卡吗？	大哥，都啥配置了还卡？有钱直接保时捷	0
笔记好用吗	就是感觉电池可能没介绍的时间那么长，其它的不错	1
怎么看外观插槽跟我那平板差不多啊？	只是我的现在都开不开机了	0
这款相机和华为p9相比哪个能好一些	会好点	0
帧数多少，	没玩过	0
像素和诺基亚1020有的比吗？	不知道，我没有用过诺基亚1020。	0
这个手机不是在京东和官网才买的有吗。这边的是不是真的哦。	这是真机，是店家在官网拿的货，由于要抢，所以店家提高了价格，可以理解。	1
散热怎么样，	我买的没啥质量问题，一切都很好，散热也比老款的强了一个档次，顺便说下，显卡和cpu都是焊死的不能换的	1
玩一些大型网游，比如王者荣耀会很卡吗？	应该会吧，毕竟运行内存不高	1
是华强北发的货。手机有没有问题啊？	我买的美版128G的，用起来没什么问题，也用GSX查过了我17-1-15买的，查询是16-12-22换的机，三网无锁，所以就是说，便宜就是碰运气，你自己也清楚	1
那个好	我觉得r9splus用着还可以！x9没用过，也没朋友在用！	0
你们都买多长时间了，	挺好的	0
可以录像吗	可以！	1
中间建了以按吗？	是感应的	1
这个玩王者卡吗，	这款游戏没玩，是正品，像素自拍发白，后置拍摄显冷淡。	0
怎样12期免息	用支付宝蚂蚁花呗应该可以12期免息，你可以问客服！	1
富士90是直接呈像，这个是不是照完还可以挑选打印。	和富士90一样，按下快门就出片。另外，这不是“打印”出来的。看过测评，徕卡无论是相纸还是机器，成像效果都更好，虽然相纸也是富士代工的。	1
高配4+32的好吗？	我的是4+32还不错，用了仨月没卡过	1
确定不是翻新机吗	全新的，大哥	1
玩王者卡吗。	不玩那个	0
这款是不是华为麦芒4正品	应该是	1
手机充电大家都大约多久能冲满	有些使用的工具都没有，不怎么好用，不建议购买像素也不好	0
电池一般能用几天啊？	看你怎么玩手机，还可以	0
45%的色域广度和72%比起来有很大差异嘛？	正版吗？？？？…………这个你在网上自己都能下到。至于屏幕方面的。。。。。。表示不解释，感觉夜清的好点	0
手机电量可以用多久	不卡,可以用一天	1
好用吗	你猜。	0
卡不卡	没试过，目测玩不了	0
这机子用时间久了，会不会掉漆	不会，看你如何保养。	1
现在销售的黑边改了吗	对了我是12月小米官方旗舰店买的 黑边大大的	0
与苹果7相比，哪个好一点	对不起，没用过苹果7。但这款机子用着个人感觉很不错。	0
日常摄影哪个比较合适呢？	日常用电动饼干就行，12-50多了一个微距而已，看个人了。	1
能分期付款的？	没试过	0
用的怎么样。	不会啊！我华为手机都用了好几个了！千元机里比较好的选择！	1
屏幕是多大的。	4.0英寸	1
请问是不是正品呀？	应该是正品，用着挺好的，这个东西也不容易仿	1
6x是不是声音小，	还行.这贵应该没问题	1
可不可以分期付款，	蚂蚁花呗可以吧	1
问下这个手机怎么取消自动锁键盘的功能啊？	我买了一个通话声音真特么的小	0
玩大型游戏怎么样	玩游戏可以哟	1
你们都配的什么镜头啊|	小白	1
可以玩pokemongo吗？	你说的那个是做啥的	0
能root么	没有注意，不过效果还行	0
办公，用lumion|revit什么的会不会卡，	卡 因为散热不好 无散热器垫的话卡的一匹 如果散热好的话无压力 3dmax2014高宣 草图大师超过1000加物体无压力 但是过热	1
套餐一带鼠标和鼠标垫吗	那就看你要用来干嘛呢！如果是玩游戏就买最高配置那种	0
请问真的是官换机吗？	这问题还真不好回答 你不信的话大家怎么回答你都会觉得是托啊    反正型号Nk开头 激活后在官网查了还有350几天的保修 你自己判断吧	1
手机收到，为什么开不开机，	应该是，没电吧	1
好不好啊这手机	还好，不怎么卡	1
用老黑莓信号超强，这款如何？	信号就那样，不过和其他3000左右的机子比起来玩游戏都卡	1
骁龙板的怎么样	买的不是骁龙版的	0
请问现在的新款战神系列笔记本电脑还支持安装|Win|7|系统吗？	最好问店家，不同平台需求不一样！	0
用的怎么样	应该是正品，用着挺好的	1
有指纹支付功能吗？	没有	1
翻新过吗	买的国行官换机128 回来没几天发现喇叭异响  商家说无法 自己卖了换的7p	0
金色前面屏幕边是白色的吗？	金色前面也是金色的噢，不是白色的	1
16g够用吗？	看你怎么用。	0
会坏吗	这个问题问的我无语回答，只想说它不是铁	1
能玩GTA？	大型游戏，合金装备5.能玩 不卡	0
能用多久啊？	可以，很不错	0
怎么样才能拍的好看	这个问题问的有水平，问的很好看。	0
大家能说说这款电脑的续航如何？	5，6个小时左右	1
套餐一卡吗，	我玩地下城游戏没什么大问题	1
通话声音清晰吗	还好	1
希望说说实话|国行的值不值|	不值	1
可以玩pokemongo吗？	没试过，不知道，玩那个估计得翻墙才可以吧，手机里面谷歌的服务应用，都得翻墙才能用，得搞VPN	0
这个手机是正品还是翻新机？	新机子，用着还行吧	1
港版系统升级到最新好用吗	我的升级了	0
能不能升级flyme6，	新机子还没有考虑升级	0
可不可以静音？	要装内存卡才可以	0
增强版玩大型游戏卡吗，	玩游戏还好，就是不能打电话	1
电池耐用吗，	放心吧，很耐艹	1
是正品还是翻新机？	应该是新的	1
美版和欧版是翻新机吗，	买了后没多久就成这样了 卖家说换屏一千多  自己看着办吧	0
这个的通话质量怎么样	还是有点小不满意，来电铃声音太小。	0
会不会用了几个月就开始卡	不会，升级系统就行	1
这个是独显吗	是的	1
能报时间吗？	能啊	1
请问国内移动信号差吗？	好像是使用省电技术4g信号平时	0
偶尔打游戏。讲真，好嘛？	不好，这款电脑只适合看视频，搞设计什么的还是去买n卡的吧，这款连lol都费劲，还有这家店耍小聪明，你要注意	1
运行速度快吗	还可以	1
屏幕边缘有缝隙吗	有，很小，不影响，两千块钱买这手机已经很不错了。	1
总的来说手机怎么样	质量有保障	1
还可以领红包吗	无返现无红包	0
卡不卡，	死机到还没发现，就是内存小了点	0
卡不卡，	不卡，用了半个多月一切正常	1
是不是拍了就秒洗出？	拍了接着出	1
为什么我拍照的时候和外面显示的是相反的	重启就好了	1
或者是用的时候有什么问题吗	挺好的，不过我用70d，全开光圈时会跑焦。	0
开热点网速快吗	没玩过，网速可以	0
好用吗，	不卡，用了半个多月一切正常	0
真心话，好不好用，	我是买给丫头用的，，读课外书用的，，不玩游戏还可以的	0
这款手机怎么样呢	不错，价格比高	1
是正品吗？	不确定，官方绑定的乐视会员没有。而且鲁大师验机不过，跑分跟正品差不多。用着一般。跟我大神F1极速版差不多	1
原装版本是哪个版本	九点几吧	1
单机身不带镜头的话也可以拿来拍照了吧？	没镜头怎么拍？	1
平时不怎么用相机的，容易学会吗？	挺好用的，很简单，海边超级实用，周围人都投来羡慕的目光哈哈	1
这个不升级能用电信卡吗	可以	1
7p充满电要几个小时	这个要看你电话游戏多不多，反正我的电话不多，看看新闻一般用一到两天	0
请问电池的电能够用多久	这个还没有测试过，我朋友也有一台，说是2天。这个要看你怎么拍了。	1
这个电脑玩儿守望先锋会卡吗？	不会，显卡挺好的	1
处理器和显卡是不是低了点？	搞清楚自己买电脑干什么用？这个配置是目前主流配置	1
侧看有什么问题吗？	一般般，分辨率没有想象中的好	0
这机子和小米旗舰店的有什么区别	一样的，没有什么区别！顺丰包邮挺快的！	1
是贴好的吗.	已经贴好的，还多送一片	1
亲们，想问这款手机信号怎么样，	我也是给我爸买的，还不错，平时打电话发短信没问题，我弟还用它玩游戏	1
只放音乐不干别的|能用吗	放音乐还不错	1
可以安装软件吗	可以，要上内存卡	1
我充电不了怎么办啊？	退货	1
充电大概高多久啊	很快的。不过不是快充。	1
这手机玩着会经常卡屏死机吗？	还行吧，买它主要就是刷机玩！	1
到底是不是正品，	好用。不错	1
这是笔记本还是上网本啊，	上网本，好用啊，速度可以，我是用于某些设备调试时传输数据	1
这个款式是我真心喜欢的，如果是个高配的智能手机就好了。这跟一般的功能机没啥区别吧	有高配的，不过要2000多块钱	0
比实体店贵吗	不好意思，没去过实体店，觉得喜欢可以买	0
想问一下买6+128的朋友，6g运存开机后还能剩下多少？	4G不到一点	1
电池好吗？	挺好的，正常使用一天	1
卡不卡，	我是买给丫头用的，，读课外书用的，，不玩游戏还可以的	1
我就想知道|通话声音清晰吗？	挺大的，适合老年人用	1
女士用怎么样？	有些重了	1
那个额度不够是什么意思	就是花呗不够	1
电池耐用吗。	送老爸的！电池没问！收货后在官网查串码了！九月出的机器保质期也到九月！应该是全新正品！	0
学生党一枚|打算买来画画cad|ug|proe|能带得动么	嗯	1
这款电脑怎样？	应付日常的娱乐和工作是没问题的，如果玩大型游戏的话还是买个好点的吧，这电脑一般的网络游戏可以用	1
支持指纹解锁么	没有	1
大家觉得慢吗	玩游戏卡	1
或者发票呢？	新的，只是对焦有点漂	0
检测是翻新机吗	一开始给我小叔买了一个，后来给我爸也买了一个，用着还行。	0
机子到底怎样？	还可以	1
三星c9华为m9哪个好？	主要看你用于哪方面	0
760d单机501.8|STM。：10-18|	真不好意思，我实际上没有买这个头，只是凑钱付款而已。不过残幅的1018估计用途比较狭隘。想走天又不想只有一镜的话建议残幅1585搭配新上市的70300二代，定焦用在残幅上会拉长焦距，得自己确认一下应用范围。啰嗦了。	1
手机用的怎么样，	电池可以，玩了一上午王者，还剩一半电	1
大陆行货是正品么？	是的，	1
这款有没有儿童模式	不清楚	0
可以拍照的吗|	主要接听电话收短信用的	0
能刮胡子不	能	1
玩王者荣耀打团的时候卡吗？	看你网速，很热是真的	0
我是8月17购买的，之前开机也显示中国移动有个4G标志，现在变2G了，怎么回事啊	可能是你手机现在所在的地方网络不好。出现3G和2G的情况是很正常的建议你到网络好的地方去试试。每天回老家我们那里差不多都也成2G网络了。	1
看着指纹解锁在后背就软了，你们说呢？	还好还好啦。	1
电池耐用吗，	用了这么长时间都没啥问题，电池没问题，指纹灵敏，音质也挺好的	1
有人买128GB的吗|	64够用了	0
接口是哪个型号	usb	1
怎样联网的？	我是用无线的  输WIFI密码	1
怎么没有手电筒啊	没有	1
你们注册“我我的尼康”是用手机注册的吗	电脑上注册的。	1
有音乐吗	可以上内存卡	0
三码合一吗？	不清楚。反正很好用	0
拍出來的照片可以貼貼紙嗎	不可以	1
有手电筒吗？	没有！！	1
是全新的吗	比其它手机耐用，我基本一到两天冲电。	0
跟xa3比较哪个好些	不是一个级别的机器，xt10要高一个档次，性能各方面都要比xa3要优秀。	1
佳能7D用这个头拍人像全身要距离多远？	好远，室外，十几米	1
请问相机底部封条开封了没？	套机底部没有拆封	1
能玩英雄联盟吗？	够呛	1
下载什么app才能把相机的图片传到手机上	你问客服，他会给你发链接的	0
音质怎么样？	音质还好	1
下载东西麻烦吗	不麻烦	1
什么系统啊	win10但我个人不喜欢这系统  因为兼容性差果断重装系统	1
请问此手机是多少价位买的？	最好先观察几晚，选最低价格时下手！	0
亲们，想问这款手机信号怎么样，	信号挺稳定的	1
玩游戏呢，	上一百兆的游戏最好不要玩	1
你们的有过无线网络不能连接的问题没？	不行就得还原出厂1设置	0
与1770c比推荐用哪个？	没问题！挺好恒定大光圈，80D半幅乘1.6系数，风光和人像都能用，刚出这个头当时不到四千	0
港版的支持验货吗？	不清楚。反正很好用	0
按键有没有不灵，	平的	0
美版不能关机充电吗？	我才发现美版不能关机充电	1
和新机比怎么样？	新的一样  电池损耗百分之10左右	1
拍出来的效果如何|	目前没有呢。我用的挺好的。拍照也不错啊	1
男的用娘么	这算什么问题。。。。	0
可不可以拓展内存	不可以	1
亲们，这个手机好不好，	不卡  可以 我都用了好久了  还那么顺	1
有没有用过远程的呀？	还没有用过	1
美版的怎么样？	不会的	0
后面是指纹吗？	是啊	1
请大家说实话，到底是不是翻新机	是嗄 他有寫上啊	1
打王者大概能打多久？	不玩游戏，不过现在一天充一次电就可以了	0
通话声音清晰吗	可以	1
为什么我购买后用了两个星期左右就感到有卡顿现象？	安卓机，用几天就重启下。偶尔有卡顿属于正常，不能跟三四千的手机比。	1
能放游戏碟吗	没有光驱，如果要加光驱最好联系卖家。	1
这台电脑厚重么|	嗯	1
套餐几是原装机？	原装也不齐全，有划痕，电池不禁用。	1
有用了两三个星期的淘友嘛，	已经刷了miui8目前一切正常！	0
屏幕响应速度如何？	一般	1
搞个手机套会不会呢	注意好，应该没事	1
是个电脑小白。想问下这个笔记本会不会像手机一样有安卓系统之分？	肯定的啊，装一个win系统，一百多吧，双系统用	1
我就想问下有多少人买了	我的手机已经涨了200了，银钻灰已经涨了1000了。	1
可以自己插内存卡吗？	可以	1
98新的有多新呀？	不知道啊 我买的32G充新机 机器挺好没有划痕 用着不会卡 挺快的	0
请问港版的跟大陆还有美版的有什么区别吗如果没有那为什么价钱不一样呢	大陆版是三网通 港版两网	1
是不是全新的手机。	不是，目前在用。	0
全网通版跟移动版哪一个性能好，	全网通好点	1
r9s有没有跟我一样充电很慢的？	没有，我这个挺快的	1
手机电池可拆卸，好吗	可以吧	1
能连无线不？	都可以吧	1
运行还有刚买时流畅吗，	手机用久了都会卡，就看你怎么用了个人感觉很好	1
套餐三怎么样？	还好吧！你要想要我可以便宜买给你	1
这手机内存是不是真的？	不行，帮同学买的，用了一天就要我退货	0
亲，手机正品不？	亲！手机是正品。像素有1300万以上。	1
如何解决？	过完年找三哥吧，会帮你搞定的	0
靠谱吗	靠谱的哦	1
这个手机能打电话吗？	可以的，就是屏幕差点，其他的还不错	1
这是正品吗？	是正品	1
想买个6p|大师门说说是翻新机吗？	我用的还可以	0
支付宝运行顺畅吗	一般	1
可以玩花园战争2吗	没问题的	1
能买吗？	靠谱的哦	1
质量怎么样呀|	质量还行可以用	1
这手机玩着会经常卡屏死机吗？	这个机子现在没有新的，都是翻新的，不知道8    9成新会不会有原装的。	0
女生|纠结买p9还是mate9...	比5.5的大一点点，个人觉得不算大，一个手可以拿下	0
尼康D7200好用吗	我配的是810，空气切割机啊～	0
玩王者荣耀|全特效会卡么？	对不起我不玩网友，不过可以告诉你骁龙820的绝对不卡	1
全网通吗	嗯！美版	1
已买的人用苹果7感觉怎么样？	很快很好	1
oppor9s|和oppor9splus|除了屏幕的大小，其他有什么区别呢？	运行内存4G_6G	1
有没有用坏了的？	用起来不方便	1
这件笔记本，续航时间多少？	没试过	0
系统会卡顿闪退吗？	我前几天用的就是奇酷青春版，用了一年多，系统不卡顿，现在还是选择360的手机，就是因为感觉系统好用。因为屏幕摔坏了才换这款。	1
可以接网线吗	不可噢，wifi就可以	1
这手机好么	可以用 用久会卡 玩不了什么游戏	1
尼康D7200好用吗	对焦慢，要慢慢等	1
怎么有评论说连放个视频都磨皮，还有说屏幕发黄的，	没发黄啊  和我朋友游匣一样	0
打出来的胶片是不是一次性的？	对啊，一次性的	1
晚上普清的一米内能看清人脸么，	不行，那天下午我试了一下，天有点阴，屋里开着灯都不很清楚更别说不开灯了，毕竟便宜货，拍摄角度也不大	1
好用吗？	64G的，一点都不卡好用，游戏特流畅！	1
手机快吗，	还好吧！别总是玩大游戏一般用足够	1
佳能80D使用怎么样？	没问题！挺好恒定大光圈，80D半幅乘1.6系数，风光和人像都能用，刚出这个头当时不到四千	1
怎么切换系统	开机按住option键，屏幕会让你选择启用哪个系统	1
可以玩阴阳师吗，	自己没用	0
买过的亲们，请问wifi信号好吗，	还可以！	1
能上网吗？	可以，感觉都还行，毕竟这个价位	1
韩版呢	我也没有试过	0
会不会不经用	没问题的，9系统不敢升级	1
这个中间的指纹解锁按键能按吗	触屏的	1
是不是官方真品，	是正品	1
可以设置双击点亮屏幕吗？	可以	1
请问手机是6G，还是4G运存，	有，运存在开机后下方显示	0
散热怎么样|	挺好的 主要 客服真的不错	1
容易发热吗。	像素不好，千元机水平，没玩游戏的情况下重度使用不发热，一两小时左右没注意充电时间。续航不错，整体很满意！如果不是很在意拍照的话强推这款。如果你需要拍照加钱买个贵点的吧	1
你们的手机屏幕色度鲜艳吗？	有這种可能，我的偏黄，像看几十年前老電影感覺	1
会不会卡屏	为什么我的没有	0
mini8拍出来清晰吗	还可以吧	1
电池…如何	还可以，一般使用一天没问题。	1
是不是金属机身？	logo那面是金属的 键盘那里就不是	1
有收音功能吗？	没有	1
会不会卡？	不卡，但耗电超级严重！	1
128G够用吗，	装双系统后只剩80，但是可以配个移动硬盘来解决，本机放文字和图片就行了	1
说句实话，手机怎样？	手机不错，用的挺爽的，手表给我家小孩在用	1
音质好吗？	电池没问题，指纹灵敏，音质不错	1
请问下是啥版本？	4_64	0
有的软件下载不了？	当然有区别，基本上主流有苹果OS系统，和PC的windows系统，两者基本上都有对应版本的相同软件，苹果最新的系统版本有部分软件装不上或无法使用	1
这手机照相清楚吗？	非常满意	1
r9s有没有跟我一样充电很慢的？	我的二三十分钟就充满了，只是电量没有传说中那么经搞	1
高配的4g的运行内存，实际能有多少能用，	用的是3个没用4g	0
是金属手感吗	是的	1
反应快吗|	一般吧	1
请问看影视清晰度怎么样，	一般般，分辨率没有想象中的好	1
这手机怎么样。	不会啊！我华为手机都用了好几个了！千元机里比较好的选择！	1
目前有个24-70f4|想拍下人像，这个镜头值得入手吗	算是FE镜头里 价格比较实惠的一个了	1
过年后会不会降价？	不知道	0
声音大吗朋友们？	太垃圾了	0
处理器和显卡是不是低了点？	应付日常的娱乐和工作是没问题的，如果玩大型游戏的话还是买个好点的吧，这电脑一般的网络游戏可以用	1
音质好吗？	放心吧，很耐艹	0
这款手机支持内存扩展吗	你真是牛?	0
是不是正品，	开始玩的时候还好，后面嘛，你懂的	0
什么系统啊	win10用着也没有什么不习惯的。。	1
打游戏会不会卡	不卡	1
可以在国外用红茶移动么？	不知道，得罪我们农村人没有出过国	0
原力金，一个软件不开，有多少运行内存	很抱歉不能帮到你，手机是帮别人买的	0
质量如何！	还好吧。	1
电脑很卡吗	我不玩游戏，平时看个图纸，还行，建议买国产的，性价比更高	1
充满电能玩多久游戏？	玩游戏4个多小时吧，但是充电快……一小时就充满	1
是正品吗？	还不错，用两三个月后有点小卡	1
与魅族mx6和oppo|r9相比怎样	我想告诉你，这款手机什么都好，就是电池太不经用了，比iPhone还不经用，除此之外，作为一个资深玩机族，真的体验非常好	1
据说新的没有大黑边了，是吗？	新款屏幕垃圾	0
遮个办公用没有问题吧	办公还可以，看视频不行	1
为什么我购买后用了两个星期左右就感到有卡顿现象？	我的没有，那你去售后检测一下。	0
是手机问题还是本来就这样？	没有出现这样的情况	0
充电多久能充满	那看你，如果边插边玩的话相对慢点。如果什么也不干，充电就一个多小时以内。关键待机比较长	1
实用吗？	并没有赠品，问就说活动过期了	0
发烫之后是不是会卡？	不会	1
一般玩个游戏会卡吗？	不会	1
玩王者荣耀会卡吗，	完美运行，我感觉还可以	1
手机好么？	很流畅，性价比高	1
请问下，你们的手机出现过信号不好和返回键失灵的情况么？	手机用了一个多月没有发现大问题，信号还是比较稳定的，返回键没有失灵的问题哦，不贴钢化膜用着舒服。	1
双4G是什么意思？	联通和移动都能用4G	1
有游戏玩么	就一个，没意思。	1
请问真的是官换机吗？	我拿到手是官换.不过是泰国版本	1
指纹灵敏吗，	电池没问题，指纹灵敏，音质不错	1
真心话，好不好用，	不好	1
这手机质量好不好	质量挺好，就是待机时间不太久，不到一星期	1
多少天充一次电	新机老人一个星期充一次	1
是不是金属机身？	不是	1
请问大家电池耐用吗？	还可以	1
玩王者荣耀|最高画质|全特效|会卡吗？	只要网络好基本没有问题	1
这个机子还有没有停产，夜景拍得怎么样？	停产了，夜景也没问题啊，看你怎么调了	1
手机卡么？	卡 真的 超级卡	1
值得入手吗	还不错~给老妈买的	0
电池能用几天！	看用多频繁，一天没问题，一般不是一直用一天半左右吧。现在华为东西不错的，用了个把月还是很流畅的。现在买好像华为还送屏幕险。	1
请问一下|是不是组装机	不是	1
请问下大家这个展示机有问题吗，	用了四个月感觉还是新的一样，买那个未激活的版本贵点，电池循坏我买的时候是0次，反正没啥毛病	1
电脑好用吗	可以	1
有一段时间不卡吗？	看用多频繁，一天没问题，一般不是一直用一天半左右吧。现在华为东西不错的，用了个把月还是很流畅的。现在买好像华为还送屏幕险。	1
你们的是不是和我的一样，屏幕不太清晰啊	屏幕没什么问题，就是做工太差，而且每隔一会就有很大的电流声	1
质量如何！	不知道。反正都那样当备用机可以的	0
声音大吗！	还行吧  不算小	1
卡不卡	没玩过	0
手机一直亮着不会黑屏，你们有这种情况吗，	要关掉屏幕长亮按键，在手机设置里面	0
|	这个我没有具体查，我用的是16G的，个人认为，它毕竟只是一部手机，不能替代笔记本等等，所以16G足够了！仅供参考啦哈	0
几g网？	不能上网	1
表面白色的和银黑那个好看些，	摩卡金+1	0
这个电脑官网报价优惠完了6999|这家店卖这么便宜是正品吗是旧件重装吗值得信任吗	用了一段时间，还行！用鲁大师检测了下！硬件都是新的！应该是正品	1
摄影效果如何？	一般、有灰	1
怎么感觉有点卡顿？	开的程序多了就会卡，刷个MIUI系统能好很多，折腾吧！朋友	1
请问手机是6G，还是4G运存，	我相信乐视，用着真的很顺	0
大家充一次电能用多久啊？	7天左右	1
现在用得怎么样	除了电用的快一点，其他还是没问题，至少用的过程没有出现什么问题，喜欢苹果的还是可以入手	1
烧主板吗	用着还可以！唯一不好的就是不能root	1
可以系统升级吗	当然可以了	1
怎样？	是正品	0
双卡双待，是一张手机卡一张内存卡吗	是两张SIM卡	1
除了手机上的东西|运行还剩多少？	一开机还是有2.28	1
像王者荣耀这样的可以玩吗，	暂时没发现有什么毛病，我是买回来灰色给我爸用的，说实话拿到手拆开就想跟我爸换手机了，不仅外观特别好看，还指纹解锁，3G运行内存  32G  还是全网通，真的想换了  我爸不干	0
手机是正品嘛，	挺好	0
目前有个24-70f4|想拍下人像，这个镜头值得入手吗	值得入手，这个镜头需要经常食用手动对焦	1
手机玩王者荣耀卡吗	不玩游戏	0
大家觉得手机怎么样？	没发现什么问题，还好。	0
或者是用的时候有什么问题吗	好镜头，原装的	0
这个手机网上买的全国联保吗？	是的	1
Z6有背光键盘吗	有	1
3110于3119那个更好？	3110 超棒	1
机子怎么样|	反正用到现在。没有问题。除了拍照声音关不掉。	1
卡吗？	是正品	0
送的耳机是正品嘛	是正品用着还可以	1
颗粒感强吗？	还可以啊	0
塑料手感怎样	不强，很好，除了系统占用有点大	1
这款手机使用到底如何？	通话清淅，定位准确，很好	1
大家好|买套餐一就是七成新的|用来直播放音乐可以吗|	可以	1
支持指纹解锁么	不支持	1
亲们，是正品吗？	绝对正品，华为手机绝对好用	1
是翻新机麽？	个人观点：应该是平凑的机子，核心部件是苹果的，其他应该是自己生产的	1
请问你们用sd拓展了么？	电池不经用，还有音质不好，其他都还好。	0
请问大家，是不是4g移动的	双网通有移动吧？不太清楚，全网通可以用，我的双网联通卡能用，不知问下商家呗	0
好不好用吗，	检测过是正品来的，到现在为止还没过	1
质量如何？	全新机，效果好。我还装了eye fi卡试过，能用。对焦快。	0
有点不放心，万一是翻新怎么办？	不好说，但现在用着还不错	0
港版是不是翻新机？	我觉得不是	1
系统更新后会不会卡	一点都不卡，怎么也是4G运存，就是要小心点用，大屏幕手机买了一个半月就把外屏幕摔坏了。花了一百元换了外屏！	1
请问电脑的密钥在哪	这个不知道	0
请问这款手机音量怎么样？	智能机音量都不大.建议买功能机	1
好用吗卡吗	根本不能用，打个字等半天，买了那么多都废了	1
美版相机怎么样	并没有区别	1
这款是不是华为麦芒4正品	可能是G7plus	0
手机像素|怎么样？	还将就吧！够清晰	1
你们购买的外包装有封膜吗？	这手机送话器不怎么好，打电话给别人，都猜测我这边信号不好。其它都行。	0
分多少期付款	我是全款	0
手机能用的住吗？	还可以吧。没有你说的内置软件之类的	1
这机子用时间久了，会不会掉漆	不会	1
请问这款手机音量怎么样？	不大，免提还是可以的	1
魅族E和荣耀6x哪个性价比高点|	我的是E，别买好垃圾的，反应的问题没人受理，而且寄去维修了一个多月	0
有送其他的东西嘛？	有送，是顺丰，挺好的，一直在用OPPO	1
有手电筒吗？	没有	1
你好，怎么查真伪	这个不大清楚，反正手机绝对没问题我一直再用，没出现卡的现象	0
运行快吗，	妥妥的，感觉无卡顿	1
请问是不是正品呀？	正品	1
请问这是组装机吗？	走线不够好，硬盘不够好，用的是垃圾三星的，可能会爆炸	0
你们都配的什么镜头啊|	镜皇	1
或者发票呢？	没有旧的成分吧，上面包装什么的挺新的。	0
我在纠结选50mm还是sigma的30m？	拍人像买50吧 拍人像买50 1.8	1
你们的是不是和我的一样，屏幕不太清晰啊	是的	1
为啥有送那么多东西？	东西真的不错，用了三四个月了，一点毛病没有，就是配置方面不是很行，不过我要的是屏幕大，当备用机的	0
亲，手机电池盖怎么打开	使劲抠	1
请问字体大吗？	字体还行 就是不是正版小米商店不能注册	1
是正品还是翻新机？	收到的是未拆封 具体里面是不是	1
容易碎屏吗，	贴了钢化膜，套上手机壳，摔了好多次都没事	1
电池耐用吗？	4G网可以到4.8M/sWiFi没注意看，我不打游戏的，看小说每天大概4个小时，电话多，可以用两天一夜留20%左右吧，正不正就不懂了，总体感觉不错	1
会很费电吗？	没问题！挺好恒定大光圈，80D半幅乘1.6系数，风光和人像都能用，刚出这个头当时不到四千	0
明明显示闪充，却要冲两三个小时的。这是什么原因？	没有，我这个挺快的	0
移动版的打王者会卡吗	不知道	0
电池咋样？	还行	1
外星人电脑|14寸好吗	这个要看你个人是要什么用途的 像我拿的就是17寸的 最主要的是玩游戏 携带性就有点偏重 这个还是要看个人的喜好的 希望我的回答对你有帮助	0
是否翻新机？	正品吧，没开封的。就是电池不给力	1
会不会出现内置软件乱收费情况呢？	能丫，以前的手机质量永远是NI.1	0
运行内存几个g	运行内存6GB。我安装了36个APP，运行起来还是很流畅。	1
这手机给老婆用好吗？	不行，买个贵点的吧！对老婆别省钱	1
不会是二手手机吧！	这个手机是新品，二手机的可能不大，不过这个是阿里系统的哦	1
能删多少，	真心不错，好手机，物美价廉，做的是小米的路线！	0
灰色3399是真的吗？	我買的摩卡金的	0
是镀金的吗？	问老板去	0
你们玩英雄联盟FPS是多少最贵的那个套餐	套餐4，显卡太低了    玩不成CF    很遗憾	0
请问这款手机音量怎么样？	老人用的话不推荐  智能机音量都不大  可以买老人专用的那种手机  价格比这个也要便宜  那种的音量和按键都比较大  比较适合老人用	1
水改行？	不知道，反正能注册官网延保，有发票	0
港版新机未激活的情况下自动关机，这正常么？	我的是国行的，也许是天冷的原因吧！	0
在这买手机可信吗	这个手机不怎么好，4g运存卡顿	1
怎样？	放心买啦！没问题的，我都帮我同事买了五部了!	0
有租他家的面罩吗|	没有	1
运行与储存空间多大？	4_64	1
电池是原装的嘛？	应该是的 反正没什么问题	1
这个录制视频后怎样下载视频？	读卡器插电脑USB，如果手机内存够，可以连接手机下载到手机上，存储卡都差不多  我是单独买的32G	1
说实话，手机是不是正品？	我验证过了，我买的应该是正品	1
能连无线不？	不行，可麻烦了	1
反应会不会迟钝呢	r9s	0
前置摄像头拍照怎么样	目前来说还可以	1
自拍咋样？	倍棒	1
主要电池耐用吗？	挺好的，用了一阵了，是正品	1
手机用着咋样	好用。不错	0
电池是原装的嘛？	应该不是	1
不能折现吗？	应该是折了的，你补差价	1
开机后机身可用内存多少？	可以购买！性价比很高的一个手机	0
外面的塑封膜还在吗	买俩月了，我买的带的，手机黑色	0
翻新机吗？	有发票，我用差不多一个月，老黑屏，闪屏，上网卡得很，经常死机。	0
是不是正品呀|	想要正品去京东，三千来块钱还想要正品。。	1
和oppo,vivo,华为小米比怎么样？	这款比你说的那些强太多了，你可以自己上网看看测评	1
这款手机支持内存扩展吗	不	1
手机只打电话电量能用多久？	那要看你打多长时间的电话了，一般不总是打的话，一天半吧	1
装虚拟机运行会卡不？	我只能说垃圾，真的，我现在超级后悔，我之前想退，卖家之前明明说了七天可以退的，后来说要两百翻修费，明明是他们电脑问题，我也是醉了	0
我怎么是一点电都没的	我的也是一点电也没有，一开始还以为是相机问题。。。	0
请大家说实话，到底是不是翻新机	这个还可以啦，比我在实体店买的别的牌子的手机好，性能强，价格低，我他么都后悔没有再买一个，而是买了个别的	0
而且反应也有些慢，怎么这么多问题	安卓机，用几天就重启下。偶尔有卡顿属于正常，不能跟三四千的手机比。	1
是不是闪充的	不是，要两到三小时	1
有没有用坏了的？	新的	1
手机按键按起来反应快吗，	不会啊，我小孩用还不错	1
买过的都有送钢化膜吗	有送防爆膜没帮你贴	1
相纸质量怎么样？	是真品。	0
moto|z有NFC功能么	有，这是个必须有	1
用起来好用吗？	是正品，挺流畅的，发热情况也很好，发热不大，玩游戏很流畅	1
大家好|买套餐一就是七成新的|用来直播放音乐可以吗|	我的已经坏了	0
有多少人买了情况怎样？	现在手机除了苹果系统，使用起来都差不多，买这个M2017送我爸，反正他特别喜欢，他觉得特别有面子，有钱难买爸高兴，哈哈。因为不在他身边，不知道用起来怎么样，但是信号真的比以前那个手机好多了，我家信号不太好，用了这个打电话不用喂喂喂了，这点最重要。也对比过其他，其他品牌都跟苹果长的差不多，三星又怕炸，我看这个M2017真皮的后盖，我觉得比较符合我爸气质，就爽快拿下了，发货也很快，金立还是很好哒	1
手机质量如何，	挺好的呀 送的东西好多 手感各方面都不错 可以下手的 这个价格 我买的是32g的 支付宝指纹付款 帅呆了	1
请问下，你们的手机出现过信号不好和返回键失灵的情况么？	没有问题出现过	1
玩王者荣耀|最高画质|全特效|会卡吗？	不会卡非常流畅。	1
或者和哪种牌子的手机差不多	自拍还是别的手机，这款手机相当实用	0
充电多久	像素不好，千元机水平，没玩游戏的情况下重度使用不发热，一两小时左右没注意充电时间。续航不错，整体很满意！如果不是很在意拍照的话强推这款。如果你需要拍照加钱买个贵点的吧	1
会坏吗	可以砸核桃，你信吗？	1
这款机子买回来需要安装杀毒软件不？	没有杀毒软件，需要自己装。	1
待机几天	待机大概3-4天吧	1
听说红米4通话信号和wifi有问题？你们出现过吗？	有时使用会卡顿	1
每天充电几次？	正常的话是两天一次，不玩游戏，完游戏一天一次	1
是不是翻新的？	我买的港版，应该不是翻新的	1
如果要玩王者卡么？	我是买给丫头用的，，读课外书用的，，不玩游戏还可以的	1
好不好啊这手机	一个多月了！感觉还好不怎么卡	1
手机是新的吗	嗯，新的	1
请问这手机通话质量怎么样，	用到现在都还好的啊	1
照相清晰吗？	可以。不错	1
我是妹子，买这个本合适嘛，	影音娱乐的话不要在意显卡了，选个cup性能高点的足已。	1
陆地也能拍很清的？	还不错。调个色，成品自己看吧	0
可以接网线吗	要买转接口	1
是正品吗？	不好说，但现在用着还不错	1
有送其他的东西嘛？	手机用着不错  用了一个月了没发现什么问题	0
女生用银色好看还是玫瑰金？	女汉子适合银色，女孩纸都适合	1
索尼Z5P双卡港版安卓6.0的软件版本是多少，	6	1
送了书包质量如何，	没有书包	1
手机能用的住吗？	这个手机不建议你买，我买完就后悔了	0
散热怎么样|	我是买来在学校用的，平常会用到办公软件，ps和追剧，散热还行，店家送了散热垫，看一下午的剧也不是很热，分辨率也还可以啊，我没什么太大的要求。偶尔玩低效lol也行，性价比还算高	1
不懂电脑|标配和高配差别大吗	反正我买的低配，用起来只能说不慢，但是绝对不快。只能干干简单的事，如果打游戏我对低配没有信心，高倍的估计强一点点，但是低配确实是不快。	0
oppor9s|和oppor9splus|除了屏幕的大小，其他有什么区别呢？	查看参数对比一下吧	0
设计之类的做图软件都能完美运行吗？	这是游戏本，注重玩游戏，那种软件对性能要求可能比较高	1
用着怎么样？	帮别人买的	0
用着怎么样。	暂时不支持电信卡  还不错  就是屏幕太小了 然后还虚标了内存	1
系统会卡顿闪退吗？	手机用久了都会卡，就看你怎么用了个人感觉很好	1
用的有没有问题？	说真的，反正我收到的是真的也没问题	1
前置摄像头拍照怎么样	一般般吧	1
可以换字体吗	肯定可以啊	1
和小米4s区别大吗？	像素不怎么样，如果爱自拍，就别买了	0
怎样12期免息	？请问些人类可以懂得问题OK	0
拍视频的话哪个更好点	不知道	0
能玩英雄联盟吗？	我不玩游戏	0
是不是官方真品，	反正我的修了一次没有修好给我，我又寄回去修了，现在都还在厂里	0
是不是问题特别多	可以，配置机芯骁龙820，此款机价格算低。	0
买了实用的亲们有应用分身吗	有，在设置里面，但是我没有使用。	1
安兔兔跑分是多少？	没测试	0
电池能用多少年啊？	多少年？多少天吧！可以，正常情况下3天左右	0
不会是二手吧	不是，目前在用。	0
港版新机未激活的情况下自动关机，这正常么？	不知道，你百度一下，看看是不是没电，我买来就马上查卡激活了，就检查激活时间。	0
套餐一带鼠标和鼠标垫吗	配置不行   几年前的老机   我套餐4都不行，看看电脑还行	0
请问盒子上的串码，B那一栏的串码是不是收货前就撕掉了的	不是	1
玩久了会不会发烫？	我不玩游戏 待机还可以 一天很足！	0
银色和金色哪个好看|	银色	1
新手|不是很懂|到底哪个好用些？	效果差不多的感觉	1
7p韩版没买多久，摄像头突然打不开了，请问三哥怎么回事？	这个应该是手机问题	1
有没有人买来已经半年了的|	除了电用的快一点，其他还是没问题，至少用的过程没有出现什么问题，喜欢苹果的还是可以入手	0
港版系统升级到最新好用吗	可以	1
翻新过吗	还好啦	0
OppOR9KM是什么意思	这么巧，我也不知道	0
现在用得怎么样	用了两个多月了 64g欧版的  目前还一切正常	1
有光驱吗？	玩一般游戏没问题	0
手机总是会重启吗	用了一顿时间之后会出现这种情况	1
会不会卡	不玩游戏，但是软件开多了就有时候会	0
待机能多久？	一天多都完了	1
128G够用吗，	看个电影上个网够用，要是费用够买个256g好点	1
设计可以用吗|	不知道哎，我只是看看视频而已	0
有用超过1个月的么	我用一个月左右了 我不怎么玩 没发现什么问题 就是别人听不清我说话 要用喊的 客服说给我换 我帕。。。所以就没换	1
开盖和关盖声音能不能关了啊？	关了做啥，老人家用的，没声音不好	1
是不是翻新机或者2手？	是正品	1
52O礼包是什么	指环支架，翻盖保护套，绕线器，耳机防尘塞，玻璃膜。我全扔了，没用，玻璃膜有点小，贴了之后又掉了，在网上又购买了牌子保护套，和纳米钢化软膜，	1
是不是官方真品，	旗舰店就是官方网站，放心吧，我一直买的	1
说实话，手机是不是正品？	我感觉没3s好  这是个人感觉	0
听说这个玩酷跑会卡|说是CPU很低|真的吗	用了三四个月了。感觉还好吖	1
有返回键吗？	看到那么多人都说有就不用我回答你了吧	1
网络好不好啊？	还行	1
我是农民工赚钱不易孩子要买请问谁怎么样是翻新的吗	你好，怎么说呢，这个价格买到的机子如果两年不出毛病不管翻新不翻新肯定是赚了，我给我家里人买的，用了一个月左右，目前没什么问题，祝你好运	1
金色前面屏幕边是白色的吗？	是的	1
网上买手机怎么分期	购买时可以选择分期，	1
过年后会不会降价？	会降价的	1
女生买什么色好看	玫瑰金吧，女孩子拿着好看一点吧	1
指纹灵敏吗，	用了这么长时间都没啥问题，电池没问题，指纹灵敏，音质也挺好的	1
港版系统升级到最新好用吗	没升级，还是9.3.2	0
为什么打电话和接电话时候会黑屏按电源键也打不开	黑屏是手机前面的距离红外感应灯，距离与脸短就关瓶。也在测试用开机健点亮，设置关闭。就是按健关闭通话可以。。	1
声音大吗？	没有	0
卡不卡	没玩过	0
它是发的顺丰嘛？	有送，是顺丰，挺好的，一直在用OPPO	1
有人买128GB的吗|	标配。	0
会不会卡	不会	1
机子到底怎样？	不错是正品	1
尼康3200能不能用？	能用是能，不过比原来配置的差一点。	1
可以把系统改为win7吗	都可以用的。	1
这个机子的性价比怎么样？	还行吧 没有宣传的那么好	1
港版的|是不是正品|	还好啦	0
电池耐用吗。	比其它手机耐用，我基本一到两天冲电。	1
适合有点耳背的老人用吗	不大，免提还是可以的	1
是正品吗，	像素还行，电池不是很好，这手机反正我没用了	0
这个是正品么	是正品，用了一段时间了	0
解锁建可以取消吗	不可以吧	0
全网通版跟移动版哪一个性能好，	不知道，我的是全网通	0
自带office|吗？	带的，不是试用，一直用。	1
加硬盘后鲁大师跑分会有啥变化吗	禁止拆电脑  拆完不算保修  真的这电脑不怎么好 还不如上船那  6000多显卡能买个1060的  买也在京东跟淘宝比较比较   他家这电脑买完小毛病特多	0
怎样知道是不是正品？	是正品	0
怎么样，	是正品，用了一段时间了	1
靠谱吗	靠谱老客服了	1
是正品吗？	经常自动关机重启，不好用，谨慎购买	0
手机充电大家都大约多久能冲满	一般在两三个小时就能充满	1
机器抗用吗？	你这语气，适合买五万左右的机子	0
这手机怎么样。	还好，用着感觉还行	1
买了实用的亲们有应用分身吗	没有	1
性价比怎么样？	配置应该是最高的了，关键要看处理器配置。oppo和vivo和这个没法比。自己百度一下这几款的配置就知道了。不过自拍狂就不要买这款了，毕竟前置摄像头400万像素。其他方面胜过多数旗舰手机。	0
和适马1770比较呢	各有所长，这个占了光圈，适马占了焦段。看你的需要了	1
是不是全封，	没有问题，正品 声音大小还可以	0
三星c9华为m9哪个好？	mate好	1
分辨率怎么样？	我买的美版，正品，4.2寸，1280*768	1
电池中度用能用两天吗？	可以的。	1
实用吗？	买的时候没选vr	0
请问是不是正品呀？	应该没问题。先在他家买的相机套机。然后买的1.8	1
外面的塑封膜还在吗	不在	1
请问你们玩LOL的时候FPS多少？	有时130左右有时30左右	1
中间的home键能按下去吗？	是不能的	1
大陆行货是正品么？	不知道怎么看翻新，反正是正品    ，使用没问题，有保修就好了	1
用不用装双系统	晓不得，只是常规学习娱乐用。没装双系统	0
新的有没有专业的验证码，	新的，只是对焦有点漂	0
我的手机里包装中没有防伪码。你们有吗？	手机后面有那些奇怪的码	1
有什么不同的吗	便宜好几百肯定有原因呗，区别去机锋论坛看看，说的很细了。用起来还不错的，很值了。	0
怎么这么便宜，	我们这实体店才卖两千块钱	1
请问这个手机是正品吗，	你猜。	0
我女儿飞让我给她买一个，用的咋样啊？	好用	1
怎么切换系统	点击设置偏好，然后点击磁盘，你会看到两个，选其中一个，点确定	1
有木有可能卖的不是正品	没必要的现在一般没有山寨机了，要是二手的机会也不大，因为这是新机刚出没多久不太可能下个鲁大师什么的，跑下分顺便也就能查设备是不是真机	1
这件笔记本，续航时间多少？	五六个小时吧	1
是翻新机么？	全新机，效果好。我还装了eye fi卡试过，能用。对焦快。	1
聲音會有雜音嗎？	一般，但是声音没杂音，没装麦克没试！	1
亲们这款手机怎么样	用过一个月后感觉反应越来越慢	1
手机用时间长了|卡吗|	一分价钱一分货    在这个价位来说还算可以的  速度快	1
卡不卡	自己没用	0
有的软件下载不了？	肯定的啊，装一个win系统，一百多吧，双系统用	1
充电需要多长时间	像素不错 很清晰 充电大概两小时就可以充满了	1
美版相机怎么样	跟国行的一样啊	1
有没有使用一年多的，	手机用久了都会卡，就看你怎么用了个人感觉很好	0
有什么优点和缺点？	电池可以，玩了一上午王者，还剩一半电	0
外星人电脑|14寸好吗	性能上应该没差，但是散热绝对会成问题的，如果玩大游型游戏就会比较麻烦	1
你们买到的手机是被打开过的么？	没有啊不清楚	1
可以战斗10年吗？	你买i7可以用十年？	1
另外套餐配的tf卡质量怎么样呢？	读卡器插电脑USB，如果手机内存够，可以连接手机下载到手机上，存储卡都差不多  我是单独买的32G	0
屏是5.5的吗	是5.0寸	1
3600好用吗|	zr都差不多的	0
m6的充电孔和耳机孔是同一个孔吗？	不是同一孔，分开的~	1
外壳是铁的还是塑料的？	塑料，不推荐	1
这款手机用了怎么样|	待机大概3-4天吧	0
谁的玫瑰金背面有中国移动标志	玫瑰金是移动定制	1
它的实品是什么样的	和OPPOa9差不多一样大，它比OPPOa9要差那么一点，就是一普通的智能机	1
店家，支持以旧换新吗？	你问老板啊，老板超美哦	0
多用PS|PR，不玩游戏，这部电脑能行吗？	可以的，妹子，很好，挺好	1
问下这个手机怎么取消自动锁键盘的功能啊？	这手机我妈用了信号贼差！	0
这款手机屏幕是不是不好啊，	从买到现在用了三个月还是两个月我忘了，双11或者双12买的。然后现在屏幕中间上方一点已经出现了一个亮点。其他不多说会继续观察	0
散热怎么样，	还行 最主要的是可以diy 但是拆机是个考验diy者	1
多少G运行？	不是翻新机是真机  2g运行	1
能不能看小说	这手机一点都不好	0
有游戏么	游戏？聊胜于无了。	1
机子有毛病吗	暂时没发现有什么毛病，我是买回来灰色给我爸用的，说实话拿到手拆开就想跟我爸换手机了，不仅外观特别好看，还指纹解锁，3G运行内存  32G  还是全网通，真的想换了  我爸不干	1
是新机吗	很好用的，全新未拆封，可以当面拆开的。电池要是3000以上就更好了	1
联通号可以用不？	就这样，可以！	1
耐用吗？	不知道啊 我买的32G充新机 机器挺好没有划痕 用着不会卡 挺快的	0
你们的max2指纹解锁正常不？	我还没用过指纹解锁	0
是指纹解锁吗？	新的，指纹解锁，看着没什么问题。	1
手机怎么样|	可以没问题不是翻新机	1
官配和套餐有什么不一样么？	不好意思我都搞不清	0
用久了会不会有什么问题？	好用啊，家里一直在用没有发现哪里不对的地方	1
比如王者荣耀开最高配置，会不会延迟，	不玩游戏，但是软件开多了就有时候会	0
16g内存系统占得多吗，	系统内存多不多无所谓  主要是手机真的不咋地  千万别买  否则会后悔	0
佳能80D使用怎么样？	还是17-50 恒定大光圈加os防抖	0
这款的APP到底怎样呀	还可以	1
这款是不是摔不坏屏幕那款？	是的	1
是正品吗？	这个手机是新品，二手机的可能不大，不过这个是阿里系统的哦	0
亲们，是正品吗？	是正品。给老婆用。赞	1
cad.3Dmax可以全面支持吗，	妥妥的，感觉无卡顿	1
52O礼包是什么	就是坑爹的，买的时候记得额外买个碎屏险，默认不勾选的，别给坑了	1
几核，	可以	0
手机一直亮着不会黑屏，你们有这种情况吗，	没有，问商家，换个	1
这微单有快门次数么？	有快门次数，但是估计你用不完。一看你就是属于刚入门被一群伪大神用快门次数唬住了。    不要想太多，正常有几个人用的完快门次数的，除非是商业需求。你能够两年内不喜新厌旧就不错了。	1
能用NFC吗？	可以，首次使用要等等	1
这款和小米比怎么样啊	还不错	1
三星c9华为m9哪个好？	必须安卓机皇我大mate9	1
亲们，手机有问题吗？	暂时没有	1
请问用过一段时间之后，指纹识别正常吗	正常啊 买过好几块手机了 都没有问题	1
我的玩个保温萝卜都卡的半死|什么情况	还好	0
这款手机插内存卡是不是存不上去吗？	内存卡可以装在手机上	1
声音大吗？	有！需要插耳机。或者下载网络收音机在线听，声音很大。	1
请问这手机通话质量怎么样，	不会，我妈那个用了两年了，让掉水里了，才重新给买的	0
带出国能装google|map么	没有试过	0
屏幕暖屏么？	颜色很好看，但是有点不正，带走护目镜	0
你们使用了小钢炮后，觉得可以配伴你们几年，	10年？哥们你想太多了吧	0
送钢化膜和手机壳吗？	还可以手机号毕竟价钱摆着呢 是送的	1
怎么样，	是正品，蛮好用的	1
说实话，手机是不是正品？	未拆封的，买来就给我女儿了！未验证过，不知道是否正品，女儿说好，就了	1
哪几个套餐是什么意思？	不知道具体，送8G内存卡那些吧	0
希望说说实话|国行的值不值|	翻新机，我的是不是有卡顿，音质不怎么样，始终没厂家翻新的好，建议到专卖店去买	1
X9好还是这个play6好	这两个就是曲面不同，曲面时尚些	0
各种毛病有吗	不卡，用了半个多月一切正常	0
求真话|买过的亲如实说下质量怎么样？	我妈说还可以，就是电池不耐用	1
音质好吗？	用了这么长时间都没啥问题，电池没问题，指纹灵敏，音质也挺好的	1
分辨率这么低，可以看电视剧吗？	没问题的，虽然分辨率不高但看个视频还是可以的，只是没有外屏从内屏拿着横屏来看多少有点别扭哈。	1
待机时间长吗？	差不多	1
电耐用吗？	像素清楚，电还行	1
为啥我看了好多家电脑，总是没有全部都说好的，总是有几个说电脑卡？	按照自己的用途买，配置高肯定价高。	0
为什么这不便宜？	除了电池使用时间短点，都还好。	0
手机只打电话电量能用多久？	太卡，边框容易掉漆	0
你们都买的哪一款？	4099那个，不卡，用起来很好	1
质量好吗，	我买的没啥质量问题，一切都很好，散热也比老款的强了一个档次，顺便说下，显卡和cpu都是焊死的不能换的	1
这个手机键盘锁能取消了，	不懂你的问题	0
差价这么大，值得购买吗	外面都是这个价了好吧	1
能放心购买吗？	我买了一个。还行，声音挺大。手机内存系统占完了。	1
男的用娘么	额，我用的银色的，感觉白的容易脏	0
有跑焦么	暂时没有	1
质量怎么样呀|	很好，妈妈很喜欢	1
卡吗？	还好，不怎么卡	1
有人买128GB的吗|	128挺好用	0
这家电脑好用吗	还可以吧。	1
T2支持volte吗	T2支持。如你要买建议不要升级。升级后卡得很。	1
有没有用过远程的呀？	没有	1
相机像素怎么样|	拍照差，电池不耐用充电慢，音质想炸了它	1
值得买吗	1000元机要求不要太好！	0
质量怎么样？	挺好   的  待机时间还可以   智能机待机时间都差不多	0
主看电影|分辨率会不会有点低	挺好的 主要 客服真的不错	1
通话时噪声吗	给家里老人买的，听说用着还行	0
除了手机上的东西|运行还剩多少？	2.3g	1
各位，用着怎么样？	正品	0
是不是卡贴的	是的，很卡	1
用着怎么样？	挺好的	1
内存怎么样，	内存还可以吧，主要是像素挺不错的，是正品，我买个一个月了，总体感觉还可以，	1
能玩我的世界吗？	这配置…10个我的世界都够了	1
可以cad制图么	质量不好，这个电脑，卡的要死	1
机子是不是翻新的	没看出是翻新的	1
日本的怎么样|	可以	1
套餐几是原装机？	没有原装机，全是组装的	0
机械师？	TF	1
想送我爸的，没用过OPPO，他就想能导航不卡，不容易摔，你们觉得怎么样	可以	1
电脑运行速度怎么样，	偶尔运行速度慢	1
能不能玩王者。	用了三天，就不行了	0
不是zr3600有紫色的吗	有啊	1
运行还有刚买时流畅吗，	刚买一个月，现在挺好的	1
绘图行么？	绘图应该可以的，这个比较偏向工作型的	1
会不会不经用	没有问题	1
这个2G的行吗	不影响信号质量	1
是几寸？	6，劝你不要买oppo	1
请问，接听声音大吗	声音不小，不建议购买。老死机	1
有没有a5100的妹子和我交流一下|	拍人像买50吧 拍人像买50 1.8	0
是翻新的么？	不知道，还没收到货，不知道物流出了什么问题，感觉很不靠谱	0
镜头重吗？	800多克，比较重，女生慎入	1
m6的充电孔和耳机孔是同一个孔吗？	分开，	1
你们的max2指纹解锁正常不？	没问题	1
明明显示闪充，却要冲两三个小时的。这是什么原因？	很快的，不知道你的原因，不过应该考虑换了充电头	0
好不好用？	嗯还可以，还回购了	1
是个电脑小白。想问下这个笔记本会不会像手机一样有安卓系统之分？	当然有区别，基本上主流有苹果OS系统，和PC的windows系统，两者基本上都有对应版本的相同软件，苹果最新的系统版本有部分软件装不上或无法使用	1
好用吗，	不卡	0
是全新的吗	送老爸的！电池没问！收货后在官网查串码了！九月出的机器保质期也到九月！应该是全新正品！	1
质量怎么样？	手机不离手，一天一冲。	0
耐用吗？	通话清淅，定位准确，很好	0
有烧主板，卡在开机Logo进不了系统的吗？	目前还没有，以后不知道啊	1
屏幕会不会有残影	发热，无残影	1
4G卡能用吗？	可以	1
预装应用有多少，	真心不错，好手机，物美价廉，做的是小米的路线！	0
这店真假不知，	买过两次港版的机器，都是原封未激活的。	1
移动版的打王者会卡吗	没打游戏，给妈妈用的不知道	0
可不可以拓展内存	这个手机太次了，几天就出现问题，建议不要买。内存没有64g	0
手机大小有手掌大吗	比手大点吧	1
屏幕真的不怎么样吗？	色域不够，不过比破tn强多了，并不发黄	1
你们不觉得小米max的屏幕黑边有点宽吗？	还可以啊，屏大	1
腾讯是山寨大王，这家是腾讯出来的，会不会一样山寨	我也是朋友推荐的。用了一个多月了。用的很好	0
这款手机支持电信卡吗？	暂时不支持电信卡  还不错  就是屏幕太小了 然后还虚标了内存	1
自带office|吗？	只能免费用一个月	1
实用吗？	能用是能，不过比原来配置的差一点。	1
五千二那款开守望高配置会卡吗	没玩屁股，LOL全画质FPS能稳定在150左右，最高上200	0
屏幕是多大的。	5.0的	1
用了过后有什么问题吗	没有，很棒。	1
值得入手吗	挺好的呀 送的东西好多 手感各方面都不错 可以下手的 这个价格 我买的是32g的 支付宝指纹付款 帅呆了	1
这款电脑质量和性能怎么样？	散热感觉一般	1
有收音功能吗？	没有	1
怎样？	是正品	0
电池一般能用几天啊？	玩的不多，基本两天充一次，屏幕大程序多，耗电量肯定也大的	1
运行快吗，	cad2016还行	1
它是发的顺丰嘛？	挺好的	0
联通号可以用不？	一般般	0
官换机什么鬼	就是那旧手机回去翻新一下  就一个手机	1
手机是正品嘛，	是，运行还可以。	1
美版不能关机充电吗？	没试过哎…	0
你好!请帮我把那英文设置中文能告诉我怎么设置吗？	选择手机设置，点确认，然后下翻到语言设置，点确认，把光标移到中文，点确认既可。	1
有没有使用一年多的，	刚买一个月，现在挺好的	1
是真的港版吗|	我是第二次买了，手机没任何问题，电池也很耐用，推荐推荐	0
声音大吗？	都差不多吧 还不错	1
像素怎么样。	像素还行，电池不是很好，这手机反正我没用了	1
大家有出现过触屏不灵的情况吗？	暂时还没有	1
请问下|这是怎么分期的？	用蚂蚁花呗	1
vivo和华为还有oppo哪个好	华为样子不好看，oppo充电快，vivo现在充电也蛮快的。听音乐也可以，6g运行可以了。	1
按键有没有不灵，	没什么问题，就是电量有点假的感觉	1
请问美版64g的型号是1687吗？	不好意思，我是16g的	0
像素可以赶上苹果吗	苹果很垃圾，各种系统不兼容，也不支持。很不舒服	0
这个相机好用吗	沒用過 還不知道	0
是正品吗？	送老爸的！电池没问！收货后在官网查串码了！九月出的机器保质期也到九月！应该是全新正品！	1
这个手机连网咋样|	我这天天连自己家的热点，一切正常	1
请问曲面容易误触吗	不会	1
这款和Sony的5100L有什么区别|	没用过索尼所以无法比较，但松下拍视频还不错，追焦反应快而且清晰	0
有来电显示吗？	有来电显示	1
手机好用吗	是正品。给老婆用。赞	1
像素怎么样？	一般，2G	1
手机像素怎么样？	可以。不错	1
音质如何？	音质一般，特别是外放的时候，但是性价比高啊	1
请问怎么打开光驱？	挖开	1
5.9英寸到底多大呀？	挺大的女孩子拿有点大	1
可不可以分期付款，	应该可以花呗分期的。  你仔细客服啊	1
是真品吗？	是真品。	1
暗影骑士3|有发票没	有	1
lol中效可以么	虽然很差的独显，但是lol还是没问题	1
这个手机键盘锁能取消了，	手机键盘锁好像是在侧边开、关的。	1
是不是正品，	这款游戏没玩，是正品，像素自拍发白，后置拍摄显冷淡。	1
请问这款手机能连WIFI吗？	没WiFi，可以上2G网	1
希望说说实话|国行的值不值|	我没用过国行，我是美版，第一次用。跟国产一样，有些功能还没国产好用	0
我想问一下，你们的拿去店里检测是正品吗？	应该是吧	1
玩DNF卡不卡？	我的不卡	1
我一直在纠结买x9还是r9，各位前辈用得怎么样，	去实体店比比看，主要看像素，内存，试试手感再决定买哪款	0
送镜头盖吗？	肯定的有啊。	1
卡吗	不卡，特好用	1
玩王者荣耀卡吗	玩是可以玩的，不卡。	1
手机是正品未拆封激活的吗，	发票没有，我要了，说有但是没有发给我，是正品	1
开机后机身可用内存多少？	全4G的，内存在27G这样。	1
在这买手机可信吗	手机挺好的，我刚买的，	1
电信4g卡能用吗？	不清楚哦，帮朋友买的。你可以问下客服。嘻嘻。。。。	0
为什么有50元的价格差	就是颜色不一样，其他都一样的，没啥差别	0
亲们，这个手机好不好，	可以，老人用不错	1
会不会用上三五个月就坏掉？	不会啊怎么会坏啊。。。	1
会不会用着用就不行了	不会啊！我华为手机都用了好几个了！千元机里比较好的选择！	1
用久了会不会有什么问题？	不会的 挺好的 没啥问题 玩王者荣耀  我个人感觉连无线网 比我刚买的oppor9s还好 一点都不卡	1
有没有人买来已经半年了的|	去年11月份买的，现在电耗得厉害	0
各位有用时间长的吗？	感觉不错	0
紫色是陶瓷机身的么	不是，陶瓷是高配的	1
x9带分屏么，	都差不多！价格和赠品没太大差别	0
760d单机501.8|STM。：10-18|	可以满足一般需求 要求高质量 还是买好的	1
这是那个上海翻新总店吗	掌柜的，砸场子的来了	0
好评好多啊？不会是刷的吧？	很好用	1
这款和小米比怎么样啊	比小米手机好一些	1
是不是翻新机？	2g/3g/4g	0
加硬盘后鲁大师跑分会有啥变化吗	还没试过	0
这款和Sony的5100L有什么区别|	不知道	0
3600好用吗|	效果差不多的感觉	0
发烫之后是不是会卡？	我不玩游戏 待机还可以 一天很足！	0
跑焦严重吗？	都跑，寄回去调焦就不跑啦	1
女生用什么颜色好啊，	我喜欢灰色，男的。	0
电信卡插上去是4g网络么？	是的全网通	1
是个电脑小白。想问下这个笔记本会不会像手机一样有安卓系统之分？	是的	1
现在用得怎么样	去年11月份买的，现在电耗得厉害	1
数据线是什么样的，	白色线，不支持双击亮屏	1
不会是翻新的吧	我也看不出来，反正用着蛮流畅的	0
WIFI能连吗，	不建议做主力机使用	0
是新的吗，	有新的，也有二手	1
大家有没有打电话的时候经常自己挂断的现象？	我不知道上次我帮别人买的	0
好不好用？	还好，给老公买的，他的要求不高，还帮他同事买了一个，都挺满意	1
玩守望先锋等开几档，	没试过，目测玩不了	0
请问各位购买客户|，机子全新未激活，	太专业了，不太清楚	0
换屏幕的话，拆下来的原屏幕咋办？	应该是折了的，你补差价	1
亲，手机正品不？	亲，手机是正品哦	1
预装正版win10么？	正版吗？？？？…………这个你在网上自己都能下到。至于屏幕方面的。。。。。。表示不解释，感觉夜清的好点	0
能下载2GB的游戏吗	我都买后悔了玩不了什么大游戏.电池一点也不耐用什么都不玩也挺不到一天	1
表面白色的和银黑那个好看些，	摩卡金	0
充电器是快充吗	不快也不慢	1
这个是正品么	是的，用着和我在实体店买的一样	0
TF？	TF	1
现在买xt1会不会过时？	不会 看你需要	1
网络怎么样？	3G	0
亲们，哪个套餐比较划算	因为是二手机，实际新旧程度从外表也不容易看出来，就拍最旧的吧，只要功能没问题，性价比很高的，我拍的7新的，也挺满意的，工作用，放身上也不怕继续变旧，磕了碰了也没那么心疼	1
那个什么情况|	港货	0
会不会很重？	和其它大哥比算很轻了	1
手机是原装未拆封的吗？	挺好的，我用的不错，物有所值	0
就是玩反应快吗那么卡吗，	物美廉价  划算	1
平常用着卡嘛？	不卡,可以用一天	1
好吗？	是的  很好用  我玩王者荣耀很给力	1
i5可以打NBA2K17和GTA5吗	没有打过，这个配置，一般特效应该可以！	1
套餐一卡吗，	那就看你要用来干嘛呢！如果是玩游戏就买最高配置那种	1
拍摄的时候要亮吗	一般日光灯下拍摄图像良好	1
来热点能用多久	我就是接打电话，五个小时行了，性价比挺高的，市面上买个二百多的基本是老年机，我只能呵呵	1
反应快不快？	还好	1
大家能说说这款电脑的续航如何？	还可以！	1
评论都是这么多字的长篇大论，不是好评多少字返现吧？	没有	1
手机卡吗？	是指纹解锁的，港版还好啊	1
指纹灵敏吗，	放心吧，很耐艹	0
在山区会不会出现信号不好的情况	华为是全球第二大通信设备制造商，华为有一个5G标准是世界未来标准之一，如果华为手机没有信号，其它的也没有，可以这l么认为	0
可以玩古墓丽影吗？	可以的，	1
用了多长时间了？	一个多月了！感觉还好不怎么卡	1
没有度数可以在里面戴隐形眼镜么|	没有	0
是不是翻新的？	外在看不出来，我没有去做测试，不放心的话买到后去小米之家测试就知道了	0
电池是否耐用	耐用，管2天刚刚的。	1
请问现在的新款战神系列笔记本电脑还支持安装|Win|7|系统吗？	买的时候和店家说	1
手机自带美颜功能吗	可以下载美颜的APP，没问题	1
请问手机开机时屏幕显示的是小米的图标还是“为发烧而生”这几个字	是小米	1
有游戏玩么	哈哈！有！不过不是网络游戏！这本身就是给父母买的手机！年轻人基本都不用的！	1
看电视电影呢？	画质不是太满意，有点卡	1
这个手机连网咋样|	连WIFI呀～智能手机都可以啊	1
这个店的手机怎么样，	真的，目前用着很棒	1
与苹果7相比，哪个好一点	用的不错	0
女士用怎么样？	有点重	1
我的玩个保温萝卜都卡的半死|什么情况	保卫萝卜。。你逗我吗，我四年前的手机都无压力，跟何况旗舰机	0
请问亲们下水后还正常吗？	没下过水额～屏幕没问题的	0
是金属手感吗	是的	1
电信卡插上去是4g网络么？	我的是移动的4G，不知道电信卡是不是4G	0
骁龙821四核和骁龙625八核哪个强	肯定821了	1
双卡双模是什么意思，	可以啊。双卡三网	1
反应会不会迟钝呢	r9s挺好的	0
反应会不会迟钝呢	去实体店比比看，主要看像素，内存，试试手感再决定买哪款	0
机子是翻新？	还好吧！你要想要我可以便宜买给你	0
打电话给别人，有杂音吗	帮朋友买的，听说用起还可以	1
请问大家，这款手机有智能拨号功能吗？	木	1
别的我也不懂，就想知道是不是正品，	是正品	1
是正品吗，	可以很好用	0
手机自带美颜功能吗	问吧	0
给老妈用，不玩游戏，就偶尔听听歌看看视频，打电话什么的|，	有点卡 老人差不多吧	1
能不能玩王者。	不行，帮同学买的，用了一天就要我退货	0
手机是新的吗？	是新的用起来挺好的	1
会不会是翻新机，	不会是翻新机，放心	1
还是本身自带root，	没弄过	0
感觉有点大，再可不可以串在钥匙环上	可以	1
质量好吗，	新款的散热很好。无需再买个体散热器	0
卡吗	好用，不卡，	1
评论差评挺多的这机子真的好用吗？	还可以	1
是不是黄牛啊	缺货把 我是上个月买的 已经4000多了 后面更贵	0
用一段时间屏幕松不松？	一段时间是指多长时间…	0
拍月亮能拍到月坑吗	不能	1
确定只是拆封|未激活的机子嚒？	我的收到已经没电，用了几天，显示循环充放电7次，也可能收到之前充过三四次，估不准。4日拍的，显示保修到明年1月2日	0
我买的是金色的，６寸屏，买的是给老人用，怎么样？	不错的手机，	1
64位吗	嗯	1
待机能多久？	充满能待机三天	1
卡不卡，	不好	0
真的可以买吗？	可以，很不错	1
魅族手机中，魅族e和note5谁更好，	我买了一台，目前运行正常	0
用着眼睛舒服吗？	个人认为还不错。	1
怎么样	128挺好用	1
这个手机几寸的	5.5	1
电脑硬盘有滋滋声，你们的有吗？	有个点 影响不大	1
有没有a5100的妹子和我交流一下|	用的是a6000	1
会不会不经用	挺好的，用了一阵了，是正品	1
请问一下,此手机是否支持移动4G或者3G	不支持	1
目前有个24-70f4|想拍下人像，这个镜头值得入手吗	值得	1
是正品吗？	电脑后面的编码能搜到	1
接收信号强吗	一般般，感觉有时候在点卡。总得来说还美观	1
这是什么牌子的手机|	一般吧	0
评论说接电话有噪音，是真的吗？	不错，很好用	1
打王者到底卡不卡，	照相像素不高，打王者还行，不卡，就是游戏玩久了最好卸载再重装个，不然会有点卡。	1
用起来卡不卡，	嗯还可以，还回购了	1
哪款性价比比较高|比较实用|	只用500了觉得很好	0
这手机照相清楚吗？	这个只是用来打电话，没有照过相，	0
亲，手机电池盖怎么打开	直接扣开就是	1
有没有买三星one5手机的|	不亮哦	1
会卡吗	可以开中不卡	1
用一段时间屏幕松不松？	我的松了	1
来热点能用多久	几乎没啥用，打打电话发信息还凑合，而且中间那触摸不灵，经常没反应	0
自拍有没有美妆功能	有	1
手机好吗？	不卡不卡手机可以	1
用多久了各位？	不卡，用了半个多月一切正常	1
有没有是翻新机的？	我拿到手是官换.不过是泰国版本	0
不会是翻新的吧	这个我看不出来额	0
现在买xt1会不会过时？	一分钱一分货	0
发热不？	感觉还可以   没有容易热	1
质量好吗？	反正退货了	0
你们的是不是和我的一样，屏幕不太清晰啊	毕竟价格摆在那里，	1
真心话，好不好用，	我老公就是买来玩游戏	1
是什么布料	没有书包	0
你们买的a59s的是固态home键吗	这个不懂。	0
苍穹灰你们买着多少	我的是月光银，很好看的	0
手机收到，为什么开不开机，	有电？	1
大家觉得手机怎么样？	还行.这贵应该没问题	0
还有卡不卡，	用了三天，就不行了	0
小白，想知道ES|不显是什么意思？	问题好模糊	0
原力金，一个软件不开，有多少运行内存	有原机自带软件	0
这手机能root吗，	可以，但root了之后没得保修	1
oppor9s|和oppor9splus|除了屏幕的大小，其他有什么区别呢？	plus电池容量大一些	1
当主机用怎样？	冲印是最新的 跟新的一样	0
请问大家电池耐用吗？	可以的	1
日版好用吗，	用电信卡选择日版苹果7p很不错，我现在用得很好	1
小白，想知道ES|不显是什么意思？	可以忽略es不显，人家主要说的是i7处理器或i5的处理器	1
随机送多少	没懂啥意思	0
手机像素怎么样？	就那样吧，不会有很惊艳的	1
笔记好用吗	好不好用要看个人怎么用了，这是一款便携式轻薄商务本，开机速度7秒，特别适合出差旅行、每天携带上下班的人群	1
可以安装psc6软件吗？	没装	0
华为mete9pro和华为mete9保时捷有什么区别	就是片面屏幕上那几个字母不一样	1
打电话给别人，有杂音吗	没有质量不错，声音大，电池扛用	1
评论都是这么多字的长篇大论，不是好评多少字返现吧？	手机没好卖，评论多少是次要	0
真的是正品吗|	我是第二次买了，手机没任何问题，电池也很耐用，推荐推荐	1
和诺基亚6比起来该买哪一部？	喜欢哪个买哪个……	0
8gwifi内存卡是什么意思|	wifi卡是用来穿照片到手机的 没插WiFi卡就不梦连接WiFi上传照片	1
卡吗？	电还可以，卡肯定会卡的	1
玩游戏卡不卡，	王者飞快	1
多少天充一次电	很好用，老人说1个多星期	1
电池是否耐用	一般吧，不算差，毕竟屏幕那么大	1
有没有出现自动关机？	没有	1
用移动卡，信号好吗？	不错，无线网杠杠的，一切都好	1
能升级系统吗？	能升级	1
手机好么？	手机不错	1
有应用分身吗	有	1
是正品不，	32g版只有黑白，64g有金色	0
打电话有杂音吗	没有杂音，音质还很好呢	1
亲们会不会觉得手机特别卡|	还好	1
骁龙板的怎么样	骁龙版的很好，速度快，系统稳定 ，还有黑科技软件，非常实用	1
请问手机是6G，还是4G运存，	手机外包装盒上我看到写有6G字样。你看看有无写	1
质量如何？	全新港货，不用犹豫，我不是托，放心	0
这款手机支持内存扩展吗	不支持	1
这款手机是滑盖的机身厚不厚啊	不是很厚	1
电池…如何	还行吧，一天一充，重度使用手机就得两次了！	1
怎么解决	没有，问商家，换个	1
到底有没有16G？	9G	1
就是玩反应快吗那么卡吗，	应该还行吧 还没有玩游戏 给老人买的 手机我不建议买旧款	0
只放音乐不干别的|能用吗	我的已经坏了	0
这个是正货吗？	是	1
旗舰店都没有送，东西和旗舰店一样吗？	送东西可能是策略吧，比较吸引顾客吧，不过确实是正品	1
都少天能到	我在北京，货一天就到啦	1
大家用得可以不？	电池不耐用其他还好	1
哪几个套餐是什么意思？	不知道	0
买了实用的亲们有应用分身吗	有   我开分身了	1
i5可以打NBA2K17和GTA5吗	我没有玩游戏，不好意思，没有办法给参考	0
可以把照片存在电脑上？	不可以	1
有鼠标和鼠标垫吗？	没有，另配	1
你好!请帮我把那英文设置中文能告诉我怎么设置吗？	手机设置设置中文就好了	1
大家买过的老乡们好，手机上网快吗？	4G网可以到4.8M/sWiFi没注意看，我不打游戏的，看小说每天大概4个小时，电话多，可以用两天一夜留20%左右吧，正不正就不懂了，总体感觉不错	1
好用么|	套餐三吧，我就买的套餐三挺好的	0
有蓝牙功能吗？	有	1
和|iPhone|7哪个好	我喜欢用三星。	1
大家好|买套餐一就是七成新的|用来直播放音乐可以吗|	放音乐还不错	1
怎么插卡啊	现在移动换的4G卡都是剪好了的小卡，以前手机卡放不上，需要自己改一下才行	1
是山寨机吗？	除了电池使用时间短点，都还好。	0
玩王者荣耀|最高画质|全特效|会卡吗？	王者荣耀都卡的话，那高通可以去跳河	1
用这感觉性能各方面还好吗	感觉还可以	1
我女儿飞让我给她买一个，用的咋样啊？	还可以	1
开盖和关盖声音能不能关了啊？	我都不清楚不是我用	0
女孩子，玫瑰金，金色，哪个好吖。	玫瑰金吧，我女的，买的玫瑰金。。	1
来电，通话声音都怎么样买过的亲们麻烦告知一下真实情况，	不怎么样，没信号	1
用了多长时间了？	还好，不怎么卡	0
女生买什么色好看	这个我也不好说，我是男的	0
能报时间吗？	按一下能报时间，能不能自己报时间我现在还不知道	1
cad.3Dmax可以全面支持吗，	cad2016还行	1
共和国之辉全特效卡不卡	没玩过这几个游戏	0
高清清晰度在什么范围	清晰度可以	0
哪几个套餐是什么意思？	不知道，我没用	0
是飞利浦正品吗	是的，质量还不错哦	1
z7sp5d1，怎么样啊	缺点：1.屏幕太次，有2处漏光    2.太笨重，不方便带，我试过，背十来分钟肩膀就开始酸。    其他都还行，如果你想要10系的显卡，还不够预算，就推荐    网上有个笔吧的评测视频，优缺点分析的很详细，适合人群也分析了，你可以找找	1
有没有买三星one5手机的|	不清楚	0
有人感觉手机是二手的吗？	新机	1
电池耐用吗？	我妈说还可以，就是电池不耐用	1
电池损害怎么样。	翻新机是肯定的。基本很多电池和硬盘都是换过的。不影响使用，毕竟价格给力。没洁癖就买	1
4G卡能用吗？	可以用	1
你们用的时候都更新系统了？	自己更新	1
会不会死机黑屏什么的	非常垃圾，介绍写那么好，后悔了就当大几百走路掉了了吧。	0
真有广告说的好？	手感没得说，但是感觉电池没有想象中那么耐用	0
买到手之后保修期是一年的吗？	手机保修貌似和销售商没关系，有问题找华为售后	0
双4G是什么意思？	卡1能用4g，卡2也能用4g，但是不可以同时用4g	1
有发票？	但不是增值税发票	1
会不会有不灵敏或是按不动的感觉？	很好，手感也不错	0
手机卡不卡？	翻新二手机	0
有没有发|票？	原装机，有全国联保单和发票的，就是玩游戏有点卡，	1
好用么|	挺好的，我用得不错	1
这款电脑怎样？	搞清楚自己买电脑干什么用？这个配置是目前主流配置	1
买回来是美图吧	是的	1
能看小说吗	不能，只能接打电话，发短信，定位	1
内存多不多？	我帮别人买的，听说很不错	0
耐用吗，	挺好的，实惠	1
本人买的手机网上真伪查询，手机串号对不上。大家都有查过吗？	我没查过，怎么查？？   我也试试	1
能照相吗？	不行	1
手机內存大吗	8G存储，2G运行内存。相信华为	1
能放小卡吗？	不能	1
可以用电信的吗	不能	1
有收音机功能吗，	有！需要插耳机。或者下载网络收音机在线听，声音很大。	1
像素怎么样可不可以拍张照看看，	系统内存多不多无所谓  主要是手机真的不咋地  千万别买  否则会后悔	0
有光驱吗？	小游戏可以的，大型网游估计不行	0
可以在国外用红茶移动么？	不知道	0
是正品吗？	不是，东西挺好的	1
5s和|360n4s骁龙版哪个好	5s好，虽然是降频版骁龙821，但是目前数一数二的旗舰处理器，跑分即可说明问题！5s的CPU和GPU很厉害，即使玩大型游戏也非常流畅，推荐	1
用大手机卡还是中卡小卡？	中卡	1
请问是正品不？	是	1
这电脑能蚂蚁花呗分期付款的吗？	可以	1
是否翻新机？	还行	0
玩一些大型网游，比如王者荣耀会很卡吗？	只下载一个荣耀 你还能玩的凑合。不用的，用的都删掉！！！！	1
你们的下水过吗？	下过水，以前z2都没问题这个更没问题	1
运行卡不卡	4099那个，不卡，用起来很好	1
亲们，S7的前拍怎么样，	前置摄像头还是不错的哈	1
能用多久啊？	当然可以买啦，几十块钱。我妈在用没什么问题。	0
用电快不	目前很省电	1
不是官换机和翻新机吧？	是官换机	1
请问一下各位老板，配件是原装的？	是的，我拿到的是没有开封的。	1
电脑会发出声音吗	有运行的声音！玩游戏声音会稍微大一些，不是很大	1
产品质量如何？	就是屏幕有点漏光   性能可以    质量不好说   CPU温度基本70左右其他还好	1
信号好吗？	好用，金立感觉国产里挺不错的	1
玩王者荣耀怎么样？	不卡，但耗电超级严重！	0
请问，接听声音大吗	一般	1
有没有使用一年多的，	我前几天用的就是奇酷青春版，用了一年多，系统不卡顿，现在还是选择360的手机，就是因为感觉系统好用。因为屏幕摔坏了才换这款。	1
你们的手机屏幕色度鲜艳吗？	想多了吧，木有感觉	1
是新机吗	挺好的用到现在挺不错的	0
有人感觉手机是二手的吗？	全新未拆封	1
请问你们安联通卡怎么设置的	我买的三网通	1
这电脑能蚂蚁花呗分期付款的吗？	你咨询下客服，应该是可以的	0
手机内存是真的吗？	是的	1
你们买到的手机是被打开过的么？	没有啊，盒子上两边的标贴都是未动的，可能手机膜是在出厂就放里的吧，	1
亚太版能用移动4G吗	不稳定，掉到3g就回不去了	1
几核，	能	0
64g实体店有卖吗	应该有吧，不过实体店貌似要贵100元吧	1
是不是真正的正品，	这个问题我不想再回答 好无语，苹果的正品很容易认好吗	0
支持电信卡吗？	只支持电信卡，是正品。	1
手机运行多少	3G	1
值不值得买？	不卡，这手机可以的，价位不高1000多点，性价比在这吧，我感觉不错，准备再买一台自己用不过送的蓝牙耳机不怎么样，毕竟是赠品	1
是不是翻新的？	不知道怎么看翻新，反正是正品    ，使用没问题，有保修就好了	0
能上网吗？	可以的，就是屏幕差点，其他的还不错	1
女生用什么颜色好啊，	32g版只有黑白，64g有金色	0
手机玩大型游戏会不会卡？	我打网游不卡	1
可以拍照的吗|	没试过，给孩子用的，能打电话接电话就行了，不过声音挺大的电池也够用	0
屏幕分辨率是不是很差	好	1
手机电池怎么样	感觉还可以   没有容易热	1
大学学CAD用可以吗	这个电脑一般用着还可以，显卡比较一般，玩游戏做渲染会吃力，如果是cad不做3维的话还是可以的，如果想省钱又功能好可以组装台式的	1
平常用着卡嘛？	不卡，就是老闪屏不知道怎么回事	1
通话声音清晰吗	还行吧	1
请问下，你们的手机出现过信号不好和返回键失灵的情况么？	没有	1
卡不卡。	不卡  可以 我都用了好久了  还那么顺	1
说句实话，手机怎样？	还可以，电池也耐用，就是送的手表，没用	1
在水下电池能用多久	自己外挂个电池，只要储存够你想录多久都行	1
怎样知道是不是正品？	不错的，正品	0
拍视频的话哪个更好点	没用过索尼所以无法比较，但松下拍视频还不错，追焦反应快而且清晰	0
小米官方这几天咋了？	不知道呀	0
耗电过分吗	还行，能用一天吧	1
办公看电影应该买套餐几	挺好的，我用得不错	0
是正品吗？	比其它手机耐用，我基本一到两天冲电。	0
是正品吗？	是正品	1
ios刚出的10.2.1版本，日版的i7能升级吗？	电信卡不要升级！联通移动可以。最好升级到10.2	1
是5s吗？	我买的就是5s用减小的手机卡就可以激活	1
办公看电影应该买套餐几	套餐三吧，我就买的套餐三挺好的	1
是不是翻新的？	是的，	1
是不是正品，	我不玩游戏 只是看看小说 看看电视剧 看个新闻啥的 自己觉得足够用咯	0
免息么	有免息的	1
能用MLAN	不能	1
定位功能有	没啥大用，买后悔了。	1
可以cad制图么	好卡的	1
这手机插卡就可以用吗？	插卡就可以用啦，电池不耐用不能用耳机。	1
是机械和固态的双硬盘吗？	不是，机械	1
会不会很重	重的 但是我这个女汉子表示无所谓	0
好不好用	这种手机利润不高，就算是翻新机也不会影响使用的！我买的就是全新的！	0
请问一下，这款电脑，玩游戏怎样？	玩一般游戏没问题	1
你们试试看音响洞洞。你们左边的是不是没有右边清晰？	没有出现这样的情况	0
Nex-5可以用？	店家应该会给转接换，我的是a6000没问题	1
用一段时间屏幕松不松？	不会啊	1
有没有前摄像头？	有	1
玩那些辣鸡游戏买个这本子的脑子没问题吗？	扫雷很好玩的！	0
手机会不会很卡？	不卡，用着一直都挺好	1
这手机能root吗，	没弄过	0
港版不翻墙的话，下软件方便不，	不翻墙可以用各种国内市场啊，也可以电脑装软件啊。没必要root现在不是玩机的没什么root需求。全家桶必须好用啊，前提你有网就可以	1
你们用的时候都更新系统了？	没有，自己更新	1
这手机1万人民币，有什么优点么	没什么感觉，个人喜好多一些吧。	1
真的是正品吗|	谁容易买官换机啊！买吧，适合咱们。挺好没毛病，买后最好别更新系统9.几好用	1
加硬盘后鲁大师跑分会有啥变化吗	没加过不知道，不过一般内存也足够用，别加最好	0
请问是否支持快充？	支持	1
手机快吗，	玩是可以玩的，不卡。	0
屏幕显示效果怎么样？	可能是因为带曲面的原因，显示效果比mate7好很多，关键是运行速度快，而且电池领用，总体来说不错，值得购买！	1
你们用了多久了卡不卡？	嗯淘友如果你看上这款手机的话你就在这家买本人用时不卡也不发烫全网就他家价格实惠	1
我的红米3x手机现在没有来电显示,请问哪位高手给我指点一下呗？	是你手机卡没开通吧？！	1
怎么切换系统	去破解才可以装win	0
可以玩古墓丽影吗？	可以	1
手感怎么样|	还行，就声音太小	1
联通号可以用不？	不怎么样，没信号	0
你们用了多久了卡不卡？	实体店的我不知道，没去看过，但是这家店的绝对不差，我买给我妈用，她很喜欢	0
怎么样分期呀！	可以蚂蚁花呗分期 可以信用卡 也可以银行卡 都可以 分3 6 9 12	1
我想问一下，难道那么多人家里面家具都是一样的吗？	我忙的没拍照，但电脑你如果只用于办公的话，真的不错，打游戏应该不行，办公没得说，开机，反应都挺不错的！	0
不支持双4G双卡双待吗？	可以啊。双卡三网	1
是正品吗？	不错，店家很好人，有什么不懂都可以问	0
买回来是美图吧	是啊	1
像素够用么	够，但是不建议买，系统不好	1
卡不？	挺好的用到现在挺不错的	1
是塑料外壳吗？	一体机，摸不出来，应该是吧。	0
晚上玩手机屏幕是不是刺眼	肯定会有得	1
有没有人买来已经半年了的|	用了两个多月了 64g欧版的  目前还一切正常	1
手机大小有手掌大吗	那要看你手有多大那	0
王者能打吗	还行，反应有点慢	1
全网通吗	全部	0
卡吗？	是正品	0
你好，我想问下手机电池容量是多少	3060	1
机身厚不厚啊？	挺薄的	1
电脑好用吗	我的打打英雄联盟，基本没啥卡顿！你具体是做什么用详细点	0
照相清晰吗？	不错，很给力。真的好用	1
支持电信卡吗？	能用就行了，正品神马的不重要	0
求问玩剑网三开全效会卡么？	没有玩过！	0
请问买过的，这个手机有保修卡和说明书吗？	没有	1
请问独立显卡是几G的，	2G，不过这个作用不明显吧	1
有点不放心，万一是翻新怎么办？	还可以啊，使用起来感觉挺流畅的	0
游戏当中出现过吗？	暂时还没有	1
是指纹解锁吗？	是指纹啊，你自己去看配置啊，不是有介绍吗？	1
怎么样才能拍的好看	自拍记得带自拍镜	1
比实体店贵吗	应该是一样的哦！	1
明明显示闪充，却要冲两三个小时的。这是什么原因？	我的二三十分钟就充满了，只是电量没有传说中那么经搞	0
屏幕或指纹解锁反应灵不灵？	我打网游不卡	0
手机是真的还是假的？	真的	1
女生|纠结买p9还是mate9...	不算大，这个外框和平常5.5的差不多大小，女生用应该没有问题	0
可爱红还是粉红色那个好看啊？	粉色	1
请问各位购买客户|，机子全新未激活，	没有吧	1
店家会帮忙翻墙吗？	你叫他帮你弄！他会的吧！就是电有点太不耐用	1
没有度数可以在里面戴隐形眼镜么|	这家东西千万别租！ 相机有问题拍出的都有问题，带去马代全都白拍了两千多张，还怪镜头罩问题怪买家没清洁给自己找一堆理由	0
预装正版win10么？	微软不开源，所以如果不是正版系统很多定制化问题他们解决不了，色域45%算显色能力比较差的屏，72%的还行吧。	1
日版的是不是激活了	是激活不久的 日版的都这样	1
用着手感怎么样	手机用着不错  用了一个月了没发现什么问题	1
是不是翻新机？	不是2g	1
会不会用着用就不行了	还好，用着感觉还行	0
z7sp5d1，怎么样啊	挺不错的。用的挺爽的。玩天刀双开高配没问题。还能再开个斗鱼看看直播。	1
这个是6sp吗	两种都有	0
塑料手感怎样	不错	1
S7和C9哪个好	S7	1
好用吗？	我帮别人买的，听说很不错	1
配件是原装的么？	配件没什么问题，我用了这么久也没什么问题，无非就是充电器和充电线用的多，耳机转换器偶尔用耳机基本不用，包装看起来是原装，国内对线的缠绕包括做工一眼能看出来的	1
和实体店里一样吗？	刚买回来还没用，看着是一样的	1
打电话有杂音吗	没有杂音	1
ios刚出的10.2.1版本，日版的i7能升级吗？	升可以升，但是我感觉10.2很好！固定在10.2不升了！	1
电信得可以用吗	千万不要在这里买，我的手机收到膜坏了，客服说好评退膜钱，好评完客服多失踪了，没有诚信的店	0
好用吗，	不卡，特好用	1
相机像素怎么样|	像素不错 很清晰 充电大概两小时就可以充满了	1
有没有用的时间久的卡机吗，	目前用了一个月，没发现卡机，，，不过价格和实体店一样，，，	1
note5|32G多少钱，	我是比较早买的32g999然后送了耳机钢化膜手机壳嗯怎么说呢？除了手机壳其他都很垃圾要自己买	1
玩王者荣耀卡吗，	我不玩网游	0
原装版本是哪个版本	ch/a ch/a	0
请问亲们拉丝银白和拉丝深灰有何区别？	我买的银色，灰色配置应该一样吧	0
你们买的a59s的是固态home键吗	是的	1
未拆封吗？	正品吧，没开封的。就是电池不给力	1
这是智能手机不	别买就行了	0
设计可以用吗|	可以了	1
卡不卡。	可以年轻人也可以用性价比不错的一款手机	0
买了有什么不满意的吗？	还好，挺喜欢的	1
联通卡能用	可以，都行	1
运行内存几个g	内存运行6G的	1
屏幕有没有不平？	平的	1
屏幕多大？	是指纹啊，你自己去看配置啊，不是有介绍吗？	0
我想问下第一次充电要充多久	前几次稍微长点吧，六个小时也够了，其它就随便了	1
华为mete9pro和华为mete9保时捷有什么区别	我表示没用过保时捷，不知道	0
说实话机子咋样不要托	用到现在没毛病。用两年就够本	1
你们购买的外包装有封膜吗？	手机还可以。我买了两个了！感觉耳机乱套的！一个是华为的还有一个是三星的！！耳机的音质很差！	0
会不会有假？	还好，感觉还是加固态硬盘好用点	0
手机能用的住吗？	能丫，以前的手机质量永远是NI.1	1
亲们，哪个套餐比较划算	全新那个	1
官换机什么鬼	不清楚	0
内存多不多？	64G的，一点都不卡好用，游戏特流畅！	0
低配版玩游戏卡吗？	不知道是不是真机	0
有收音机功能吗，	智能机，就算没有也可以下载，声音大！	1
请问续航大概多长时间？	充满电看视频3小时还有一半电显示，估计5～6小时沒问题。	1
64GB够用吗	看个人习惯了，我勉强够用，平时不下载太多视频就没问题	1
不买wifi卡可以吗	可以，就是不能直接传到手机上	1
能玩王者荣耀码	两个都可以	0
赠品里的VR眼镜什么用啊？	买的时候没选vr	0
亲们，这个手机好不好，	可以年轻人也可以用性价比不错的一款手机	1
大陆行货是正品么？	我买的港版，应该不是翻新的	0
32版开机运存剩多少	2.2左右	1
设计可以用吗|	不知道，但运行速度反应较慢	0
用着怎么样。	不支持电信！移动，联通都行。	0
日版好用吗，	我觉得还可以啊！个人适应，有的人可能不喜欢。	1
样子笨拙吗？	还行，不差	1
电池损害怎么样。	值得买。小白觉得机器无瑕疵	1
港版的|是不是正品|	买的国行官换机128 回来没几天发现喇叭异响  商家说无法 自己卖了换的7p	0
会不会用上三五个月就坏掉？	看人品和运气…	0
45%的色域广度和72%比起来有很大差异嘛？	主要是色彩鲜艳。肯定不如72%的。但是影响不大。如果你是PS。设计的。就不要用了。玩游戏的没问题。	1
夹在公路自行车把上，小震动颠成shi了，一点也不防抖..有啥解决办法没？	我也没有试过，不过，你可以放到头盔上，肯定防抖。	0
手机是真的还是假的？	手机是真的，可是电池不好，服务也不好	1
你们的手机屏幕色度鲜艳吗？	偏黄是有护眼模式！颜色的话我的se跟之前用的4s是有差别，建议苹果官网买	1
充电指示灯到底亮不亮？	不清楚	0
有没有前摄像头？	有啊	1
有用超过1个月的么	有	1
大家都买联保了吗|	没买，	1
欧洲版的怎么样	不错的，和国行一样的！	0
能玩我的世界吗？	没玩过	0
z5好还是xz？	主要看你需要大屏幕还是大储存 z5p屏幕大	1
玩大型游戏怎么样	我只看电影，不玩游戏。	0
可以高配运行么，	照相像素不高，打王者还行，不卡，就是游戏玩久了最好卸载再重装个，不然会有点卡。	0
我想问一下，你们的拿去店里检测是正品吗？	帮朋友买的，不知到？	0
低价手机集体缺货？	不知道呀	0
这个中间的指纹解锁按键能按吗	触控	1
系统更新后会不会卡	还行	1
hd6470丶hd7570和hd4000哪个强呀，	可以，HD4000中高特效稳定八九十fps	0
看看电影，续航有多久？	续航不行，因为是标压，你要续航能力买低压的	1
高清和超高清是什么概念，	百度或许会更好。高清720P，超高清1080P。都是指图像像素的清晰度而言，至于压缩或者解码后如何，不得而知。其实480P就已经可以的	1
像素好不好？	像素就平常这样，玩王者1个小时轻微发热，充电1个半小时左右	1
这手机好么	还可以	1
是正品吗？	正品吧，没开封的。就是电池不给力	1
学生党一枚，喜欢打游戏，内存大不大	我在打王者  信号好  就不卡	0
卡怎么放	你这问题问的 没用过手机啊	0
那些大型游戏么	不行	1
用来办公效果如何？	不知道会不会，经常会出现运行内存已使用99％,不知道什么问题	0
花呗每月自动扣除吗	嗯 你里面有钱就行了	1
D90能用不	能的，而且很好用。	1
玩战地1表现如何？	台式机的cpu加上没有缩水的1070显卡，没有玩不了的游戏	1
电池才3000毫安，续航是不是很差，	不清楚，我只是拿来当备用机，连4g待机能有三四天吧。我一般也是三天才充电一次。	0
为什么我购买后用了两个星期左右就感到有卡顿现象？	没问题啊玩游戏啊什么的OK	0
只放音乐不干别的|能用吗	可以	1
有没有这台机器里相机照的照片|	拆机？不会，所以也没有图片	1
套餐一卡吗，	配置不行   几年前的老机   我套餐4都不行，看看电脑还行	1
建议购买吗	用电信卡选择日版苹果7p很不错，我现在用得很好	1
内存多不多？	还行	1
可不可以静音？	这手机一点都不好	0
分多少期付款	你可以咨询店家，我是全款买的。分期估计手续费会有好几百吧。不划算。	0
用的怎么样。	还好，用着感觉还行	1
用起来卡不卡，	前后共买了三部，都给爸妈他们用，他们下载的东西不多还行	1
外观怎么样，	值得买。小白觉得机器无瑕疵	1
质量如何！	还好吧！你要想要我可以便宜买给你	1
手机是全新未开封的吗	是的，未开封	1
照相清晰吗？	就那样吧，不会有很惊艳的	1
是正品吗？	他们说是翻新机	1
用了多长时间了？	我是MOTO粉，一直用MOTO。这个价位MOTO不是性价比最高的，都是绝对够用，质量OK	0
电池是原装的嘛？	我帮朋友买的，我也不太清楚	1
电池耐用吗？	可以啊	1
玩游戏卡不卡，	卡，刷的移动4G的系统，广告贼多	1
韩版的怎么样，	便宜好几百肯定有原因呗，区别去机锋论坛看看，说的很细了。用起来还不错的，很值了。	1
灰色3399是真的吗？	我的就是灰色发的银色，不过银色并不能说丑	0
能升级系统吗？	给我父亲买的，我也不知道能不能升级…	0
是新机吗	电量用的有点快	0
速度怎么样	卡 因为散热不好 无散热器垫的话卡的一匹 如果散热好的话无压力 3dmax2014高宣 草图大师超过1000加物体无压力 但是过热	0
这个手机是正品还是翻新机？	这种手机利润不高，就算是翻新机也不会影响使用的！我买的就是全新的！	1
可以把系统改为win7吗	没改，不知道，应该可以	0
可以在官方服务中心保修吗。	可以保修	1
会容易变烫吗？	一般就ok	1
送钢化膜和手机壳吗？	还有自拍杆，手机卡槽	1
美版和欧版是翻新机吗，	一切正常	0
刚买回来就可以激活了是吧？	肯定全新未激活的啦，我买之前跟营业员确认过了这是苏宁官方自营的店，放心买吧。下单之后让快递寄到你离你家最近的苏宁易购实体店，到货之后你去取货，营业员耐心会很好帮你查看机器的外观是否有瑕疵，如果有瑕疵你可以不收货。快递员可就没有这么好的耐心等了。机器很好用，哈哈我之前的16G用着真是累。	0
有收音功能吗？	没有收音机功能	1
看着指纹解锁在后背就软了，你们说呢？	不影响啊	1
小米5splus同华为mate8、荣耀v8比，屏幕的显示效果哪个好？	m8显示效果好，但速度第一	1
是全网通，全4g的吗？	全4G的，内存在27G这样。	1
手机电量可以用多久	不卡，就是老闪屏不知道怎么回事	0
可以带动英雄联盟嘛？	不知道，没试过。	0
请问红米pro和红米4note哪个好用一些？	个人觉得红米pro～	1
摄影效果如何？	全新机，效果好。我还装了eye fi卡试过，能用。对焦快。	1
可以拍照的吗|	可以，但相素很拉圾，不介意用来拍照	1
值不值得买。	我买回来拿去实体店请朋友验过，是正品，机子也很好用。值得购买，但是电子产品买还讲运气^_^	1
充电大概高多久啊	看你怎么玩，高度联网玩凑合一天，中度联网一天，低度有时联网有时短网也就玩2天左右	1
我刚买了一部，网页是6G，收货打开是4G，是咋回事	我相信乐视，用着真的很顺	0
会不会很重？	不重	1
OppOR9KM是什么意思	不知道	0
带几块电池呀	两块	1
这个苹果7便宜|真的假的吗	肯定是真的，不信就不要买，真是的。你这人不适合网购手机。	1
这是正品吗？	应该是正品	1
会不会死机黑屏什么的	死机到还没发现，就是内存小了点	1
请问是64G还是64GB谢谢	我买的还好用了2月暂时没什么问题	0
这款和Sony的5100L有什么区别|	我能说买回来还没用吗	0
自拍咋样？	自带美颜还不错，像素挺高，最好别升级系统，否则不好用	1
信号如何！	信号就那样，不过和其他3000左右的机子比起来玩游戏都卡	1
可不可以分期付款，	可以分期	1
显示怎么样？	这屏幕显示能好么，都是买了之后手动换屏的	1
这个玩王者卡吗，	开始玩的时候还好，后面嘛，你懂的	1
这款笔记本1366x768的屏幕看着怎么样啊	不好	1
几核，	两个都可以	0
是不是金属机身？	不是	1
有没有用了很久的人|	不会的 挺好的 没啥问题 玩王者荣耀  我个人感觉连无线网 比我刚买的oppor9s还好 一点都不卡	1
哪款性价比比较高|比较实用|	个人感觉TR150毕竟是网红款还是看你自己的啦	1
有没有用过远程的呀？	很好用	1
7p充满电要几个小时	我用的ipad的充电器，一分钟1%左右	1
外星人电脑|14寸好吗	不好	1
跟w2015比选哪个啊	W2015没用过但是909也不太好用，	0
这个手机几寸的	5.5的	1
能不能插电信卡呀？	能听清特别棒	0
学生党一枚|打算买来画画cad|ug|proe|能带得动么	个人感觉不厚。	0
银色部分全是吗|	银色部分是金属的	1
阳光下能看清屏幕吗？	超级垃圾一个月就扔了	0
有没包装盒？	当然	1
确定是新机吗，	我也看不出来，反正用着蛮流畅的	0
亲们会不会觉得手机特别卡|	保卫萝卜。。你逗我吗，我四年前的手机都无压力，跟何况旗舰机	1
三星c9pro是正品吗？	是的	1
跟w2015比选哪个啊	没有可比性	0
玩游戏会不会卡？	一般就ok	1
烧主板吗	很好用没有烧	1
我的卡插不进去怎么回事？	去营业厅换卡	1
谷歌全家桶能用吗	不翻墙可以用各种国内市场啊，也可以电脑装软件啊。没必要root现在不是玩机的没什么root需求。全家桶必须好用啊，前提你有网就可以	1
值不值得买？	一分价钱一分货    在这个价位来说还算可以的  速度快	1
手机卡么？	刚用还没啥感觉	1
m6跟m6s有什么区别还是有哪个地方不一样？	多了1g内存	1
怎么比旗舰店.京东自营便宜那么多啊，是正规货源么，	放心买吧我用了一个多月没问题都查过了正品	1
送钢化膜不？	送呢	1
6300可以用么？	可用，全画幅可给半画幅用	1
待机多久呢？	不好用，一下子就坏了。而且很卡	0
大家有没有觉得这个机子非常轻|快门声很钝？	机身是挺轻的，快门声钝？是你快门速度调的慢吧？	1
问一下，内存32G的，实际内存多大？	我买的64g      32的实际内存只有25到24g    日常也够用了	1
大家都买联保了吗|	没必要	1
手机只打电话电量能用多久？	一天多	1
或者和哪种牌子的手机差不多	像素不怎么样，如果爱自拍，就别买了	0
好不好用？	前后共买了三部，都给爸妈他们用，他们下载的东西不多还行	1
然而真的送32G内存卡了咩	没有	1
买到手是不是客服说的6+128的，	旗舰店就是官方网站，放心吧，我一直买的	0
2400买的会是好的新的嘛	我星空灰是	0
16g够用吗？	我的是够用，毕竟东西下的不是很多	1
还有同样的价格别家店比旗舰店的赠品丰厚很多，会不会手机有猫腻呢？	都差不多！价格和赠品没太大差别	1
电脑运行速度怎么样，	办公运行很快，得心应手。打游戏就不知道了	1
这个银色的那些部分是金属的啊|	银色部分是金属的	1
只能安电信卡吗	是的	1
耗电吗？	电还可以，卡肯定会卡的	1
用移动卡，信号好吗？	很好	1
屏幕真的不怎么样吗？	没发黄啊  和我朋友游匣一样	0
值得买吗	不值得	1
为什么有50元的价格差	我买的银色，灰色配置应该一样吧	0
这手机好用吗，	做工渣，wifi  数据断流严重 建议不要买	1
充电指示灯到底亮不亮？	亮的，充的时候是红。满了变绿灯	1
怎么只有淘宝这家卖呀	想要正品去京东，三千来块钱还想要正品。。	0
怎么样分期呀！	对呀问卖家	0
耐用吗，	不值得	0
有没有用了很久的人|	没啥问题把。苹果用着还不是出问题	1
我主要是给3岁的女儿拍照片，偶尔拍风景，35和50哪个好用，	如果有很多镜头，50照人像绝对没问题。如果想这个镜头功能多一些，建议35的	1
用移动卡，信号好吗？	还可以！	1
如果要玩王者卡么？	不好	0
是不是拍了就秒洗出？	相机名字就叫拍立得你说呢  哈哈哈哈哈哈哈	1
玩我的世界能加mod吗	给孩子上大学用的，不玩游戏	0
开得了4g流量吗	不能	1
新手|不是很懂|到底哪个好用些？	zr都差不多的	1
买什么玩LOL不卡	Lol不吃配置	1
看电视电影呢？	不会，不过最好别下360	0
配700d的机身，成像有缺点吗，	一样够用，不说50/1.4，就是50/1.8都挺不错	1
手机电池怎么样	还可以，发热肯定都有，它要热的话也很烫手，电池也还可以，有点小。它最大的特点是整机重量轻	1
有点不放心，万一是翻新怎么办？	不确定，官方绑定的乐视会员没有。而且鲁大师验机不过，跑分跟正品差不多。用着一般。跟我大神F1极速版差不多	0
能放小卡吗？	放不了	1
不支持双4G双卡双待吗？	但是像素黑的时候拍 特别感人	0
屏幕有没有不平？	我用了没什么问题	1
有指纹支付功能吗？	不清楚	0
手机玩王者荣耀卡吗	不卡	1
请问这款手机能连WIFI吗？	不，坑货连星期几都没的。	1
请问你们用什么颜色好看些？	摩卡金	1
请问这款手机牌子的名字叫什么，	不清楚	0
分辨率这么低，可以看电视剧吗？	4G速度肯定可以	1
这款电脑可以买吗lol可以玩吗卡吗总体来说值不值这个价格售后怎么样	能玩不卡，售后这个没体验过，东西没遇到问题找售后干嘛。	1
打实况会烫吗	不玩游戏，不好回答，不过建议更高配置	0
陆地也能拍很清的？	挺好用的，很简单，海边超级实用，周围人都投来羡慕的目光哈哈	0
好用吗卡吗	当备用机，可以。玩游戏的不推荐	1
会不会卡机	是正品，用了一个多月了，还可以	1
买来玩lol和炫舞卡不卡？	不会，不过最好别下360	1
店家W号多少？	问客服就可以	0
网上买手机怎么分期	付款时选择分期就行了	1
运行内存到底多少	2G	1
女生用什么颜色好啊，	正品 月光银没有他们说的那么难看	0
选哪个套装合适呢	魔眼套装好，哈苏模块又拉风又给力	1
像素够用么	像素可以	1
有自动开关机静音功能吗？	有	1
是新的吗，	新的，99新那种是柜台机	1
怎么分期，	蚂蚁花呗额度够，可以直接选择分期，下单的时候下面写的呢	1
送的耳机是什么样的	手机单独插个耳机听歌还行，毕竟送的耳机，音质不会怎么滴。但就是插着充电器再插着耳机听歌，那踏马的耳机里啥音乐都被电流声覆盖了，都听不了。反正就一句话插充电器再插着送这个耳机都是电流声就是了	1
可以直接换屏保吗l	屏幕保护膜？可以啊，不过发给我的不够宽，粘不了整个曲面，后来还是花十块钱在外面重新做了个。	1
亲们，是正品吗？	正品，激活日期和码都没问题	1
是不是正品呀|	用的还可以！	0
亲，手机正品不？	是用着还不错像素也还好	0
怎么只有淘宝这家卖呀	用的还可以！	0
不可以用4G？	还行，三G哦	1
机子是翻新？	不知道。反正都那样当备用机可以的	0
各位己购买淘友们，国行的机子你们有真正去苹果售后那验证过了吗？	这个问题我不想再回答 好无语，苹果的正品很容易认好吗	0
那里面有没有剪卡的，	我告诉你我都没注意	0
解锁建可以取消吗	送给亲戚的，不知道啊！	0
录像好吗？	不错的	1
可以玩多久？	还可以，就是很耗电。	1
玩王者荣耀卡吗，	没玩过，网速可以	0
打算带去学校用|10天的够不够	够了，充一次电一个月	1
手机好不，	300多，和我去移动换的那台一模一样，可以了，移动卖600，到手至今未发现问题，做备用机，值得买！	1
日版的是不是激活了	是激活不久的 因为日版是有锁机 店家在日本购入的时候必须激活才能购买	1
3G＋32G拍哪一个，	你喜欢什么类型，拍什么类型。	0
z7sp5d1，怎么样啊	差不多所有游戏都可以高配玩，但屏幕是TN屏	1
我刚买了一部，网页是6G，收货打开是4G，是咋回事	手机外包装盒上我看到写有6G字样。你看看有无写	0
店家会帮忙翻墙吗？	不知道，我是自己找的翻墙软件	0
我已经有镜头单买机身行吗	可以啊，	1
单机身不带镜头的话也可以拿来拍照了吧？	你在搞笑吧……买单反前多多少少也应该有一些了解啊	1
耐不耐电？	还行	1
有双击息屏的功能吗	白色线，不支持双击亮屏	1
亲们，S7的前拍怎么样，	可以	1
请问你们买的联通4g手机有没有出现过用不起数据网络这种情况！	暂时还没	1
电信4G可以用联通4G吗	可以	1
分期付款是怎么算的	你点击购买，提交订单，付款前就能看到，12期的话大概200多点	1
听说红米4通话信号和wifi有问题？你们出现过吗？	还行吧	1
32版开机运存剩多少	22左右好像	1
运行内存几个g	运行内存6G	1
选哪个套装合适呢	魔眼套装好！哈苏相机模块好拉风	1
请问下大家这个展示机有问题吗，	翻新机是肯定的。基本很多电池和硬盘都是换过的。不影响使用，毕竟价格给力。没洁癖就买	1
64g的用着会卡吗？	不知道啊 我买的32G充新机 机器挺好没有划痕 用着不会卡 挺快的	0
我已经有镜头单买机身行吗	可以的	1
电池耐用吗，	电池可以，玩了一上午王者，还剩一半电	1
请问美颜效果如何？	可以。脸上的斑看不见。美肌模式拍。	1
我就想问他那个wifi为什么不能用	功能键+F4	1
电池耐用吗？	还不错，用两三个月后有点小卡	1
套餐四得快不快？	还不错	1
夹在公路自行车把上，小震动颠成shi了，一点也不防抖..有啥解决办法没？	我还没在自行车上试过	0
能下载2GB的游戏吗	我没下游戏光打电话了 太小不能玩游戏	1
翻新机吗？	是正品的，建议买3g运行的，我的用的很好，游戏不卡	1
多少天充一次电	老人用1星期吧	1
可以玩游戏么	可以	1
手机是原装未拆封的吗，	是，电池还耐用，我的是3+32	1
要装电池才能用吗	不是	1
WIFI连接会不会不稳定？	不知道，	0
这款手机支持电信卡吗？	不支持电信！移动，联通都行。	1
多久呀？	四五天吧	1
电脑运行速度怎么样，	还行，用得不错	1
像素怎么样。	像素清楚，电还行	1
是不是卡贴的	哈喽，非常高兴你能问我，只是我不明白卡贴是嘛意思	0
怎么激活	我买的是5s	0
note5|32G多少钱，	价格以店铺为主，价格幅度比较稳定，标配有手机膜，手机套，耳机。	0
有这么多官换机么？	哈哈  你爱买不买 爱信不信 就你有脑。	0
电池损害怎么样。	用了四个月感觉还是新的一样，买那个未激活的版本贵点，电池循坏我买的时候是0次，反正没啥毛病	1
自提有赠品吗？	没有	1
请问下|这是怎么分期的？	蚂蚁花呗预支付全额  然后每个月往蚂蚁花呗里面还款	1
这怎么长得和三星一个样	真心一般！	0
我想问下，怎么把后盖打开上电池？	是把整个塑料后盖拿下来	1
粗磨屏吗	花呗可以分期，	0
使命召唤13全特效卡吗？	没玩过	0
vivoy66好还是这个好？	我觉得还是小米好一点吧	1
会不会卡屏	卡，刷的移动4G的系统，广告贼多	0
韩版呢	没试过哎…	0
这手机照相清楚吗？	我不要求像素，所以…	0
卡不卡，	我只能说，买了很后悔，我当初就是图便宜了	0
mini8拍出来清晰吗	看个人水平 很难拍的	0
玩我的世界能加mod吗	软件的东西，只要你下载的版本没出错都可以装。	1
买过的都有送钢化膜吗	我是有的，不过没有用。	1
外观怎么样，	翻新机是肯定的。基本很多电池和硬盘都是换过的。不影响使用，毕竟价格给力。没洁癖就买	0
设计之类的做图软件都能完美运行吗？	不好意思，我买来目的是玩游戏	0
质量怎么样呀|	还行	1
买到手是不是客服说的6+128的，	是正品	0
充电多久能充满	两小时	1
请问美版64g的型号是1687吗？	手机用起来挺流畅的，没问题！	0
开盖和关盖声音能不能关了啊？	可以的	1
总体来说好吗	可以	1
搞个手机套会不会呢	不会碎，但是屏幕闪烁很严重，还没有想到好的解决办法	1
如何解决？	重启试试，不行的话找老板	1
希望你们能回答我，这个镜头有一点旧的成分吗？	没有旧的成分吧，上面包装什么的挺新的。	1
有佳能550d的机主买了这个头吗？	跑焦跑得挺厉害，网上租了个底座调好了	1
收到货时机子背面有入网许可证吗	有	1
手机一开始都没电吗？	卡，有电是不是你没把电板装上？我来说下这手机的拍照，字那字有重影看不见，我主要是看他是全网通才买的	1
笔记好用吗	除了系统比较不熟悉，第一次用win10，其他都很好，速度很快	1
有卡槽吗	有啊	1
手机是不是真的	是啊！	1
想买个6p|大师门说说是翻新机吗？	不是翻新机是全新官换机	1
这手机能root吗，	没弄过	0
渲的时候卡不卡	妥妥的，感觉无卡顿	1
还有字体大吗，	质量还行，就是守护宝不好用	0
大家用过一段时间感觉怎么样，	信号不太好，其他都很不错	1
能装cad2007吗	可以啊	1
哪款性价比比较高|比较实用|	都好，看你自己需要，个人觉得600很好，而且新手很容易上手，照出来照片不会反	1
是不是官配的就是裸机啊？	不好意思我都搞不清	0
不懂电脑|标配和高配差别大吗	没错问题 看自己需要空间的	0
这手机好用吗，	可以，配置机芯骁龙820，此款机价格算低。	1
电池是否耐用	不耐用，买了后悔退不了的，屏幕有阴阳光，投诉没用啊，淘宝赔了我500元	1
亲们，除了掌阅，哪个读书软件app比较好用呀？	我用掌阅	0
这款手机到底好不好	一般般	1
会不会用着用就不行了	不会啊，挺好的，建议买4G的	1
有蓝牙功能吗？	有	1
预装应用有多少，	二楼正解，以前360OS附的天气是最美天气，个人比较喜欢，简洁精准，现在变成了墨迹，一堆的APP推广，一直恶心这个，看见墨迹俩字，第一个动作就是卸了它。    天气预报都能卸！不过桌面自带简易预报，这个插件卸不了。    不想要的基本上都能卸。	0
是正品吗？	不是	1
是真的港版吗|	谁容易买官换机啊！买吧，适合咱们。挺好没毛病，买后最好别更新系统9.几好用	0
请问红米pro和红米4note哪个好用一些？	红米Pr0	1
有佳能550d的机主买了这个头吗？	都跑，寄回去调焦就不跑啦	1
请问此手机自带收音机吗不是网络的那一种	老板没信誉，手机看你运气咋样不是每个都好着呢，要不你试试运气看老板是人不，插耳机才能听FM	1
低配版玩游戏卡吗？	卡不卡是要看你玩什么游戏了，百度游戏名加手机配置，会得到你想要的答案。	0
我是妹子，买这个本合适嘛，	这个本本更适合打游戏的，	1
感觉有点大，再可不可以串在钥匙环上	没有，还可以	1
像素怎么样。	内存还可以吧，主要是像素挺不错的，是正品，我买个一个月了，总体感觉还可以，	1
手机按键按起来反应快吗，	很好，手感也不错	1
怎么分期付款？	li'yi'gou'mai	0
配700d的机身，成像有缺点吗，	挺好的，不过我用70d，全开光圈时会跑焦。	1
好用吗？	还行	1
我怎么是一点电都没的	没电，自己充	0
请问相机底部封条开封了没？	查过，盒子、机身、镜头、主机内码（用eosmsg软件）四码，能对得上。	0
有没有买三星one5手机的|	亮的，充的时候是红。满了变绿灯	1
在小乡村里可以用不，	可以用，待机还可以	1
好不好用吗，	是正品，万一出了问题去苹果售后可以的	0
请问这个可以再自己插一个512固态，一个2T机械吗，	固态硬盘容量没有限制！机械硬盘说明书上说只能装1T的，但有2个接口可装7mm和9mm各一个，建议按说明书来。	1
每天充电几次？	我每天都要充一次的 似乎电池感觉一般	1
用的怎么样	正品，激活日期和码都没问题	0
能买吗？	靠谱老客服了	1
欧版能不能用电信的啊	No！国行，美版 全网通。	1
多长时间充一次电呢？	给家人用的，好几天充一次	1
续航怎样啊，	我每天都要充一次的 似乎电池感觉一般	1
套餐四得快不快？	假4核     不是很好	0
16g够用吗？	还行，看你怎么用	1
屏幕泛白？	还行.这贵应该没问题	1
m6的充电孔和耳机孔是同一个孔吗？	不是，分开的	1
这个电脑官网报价优惠完了6999|这家店卖这么便宜是正品吗是旧件重装吗值得信任吗	正品	1
你们注册“我我的尼康”是用手机注册的吗	可以的	0
360N4A这款是正品吗？	是正品，挺流畅的，发热情况也很好，发热不大，玩游戏很流畅	1
王者荣耀卡吗？	一般吧	1
是不是官配的就是裸机啊？	是的，官配连个包都没有	1
SSD速度怎么样，	很快   很好	1
设计之类的做图软件都能完美运行吗？	应该可以吧！	1
360N4A这款是正品吗？	应该是吧！用着还不错	1
可不可以分期付款，	可以分期，但要收手续费	1
你们的手机出厂日期多少？	没注意	0
手机sin塞不住老掉怎么搞	还厂家	1
这个笔记本有没有带WIFI？	有的	1
请问是怎么装储存卡的	没有储存卡，内带	1
能放小卡吗？	只能放大卡	1
机身是玻璃的还是金属的？	金属	1
请问用过一段时间之后，指纹识别正常吗	目前没问题	1
感觉质量怎么样？	新的	0
用起来好用吗？	应该是吧！用着还不错	1
多用PS|PR，不玩游戏，这部电脑能行吗？	刚用，ps啥的没问题～	1
这手机给老婆用好吗？	买y67配置应该好些！	1
玩王者卡吗。	不玩游戏，不知道	0
你们用的时候都更新系统了？	是的	1
跟xa3比较哪个好些	是啊 价钱都走不少	0
请问32G和64G除了存储大小之外还有什么分别吗？	没有	1
金色和白色哪个好	白色	1
好吗？	我买的移动版，用着还行，玩大点的游戏卡，我玩的王者荣耀。感觉跟我499买的大神F1极速版差不多，那个是2G运存8G存储的。玩游戏建议CPU骁龙820的。这款包装看着是原封，但我用鲁大师验机不识别，跑分是跟原厂差不多。但绑定的乐视会员在官方没查到。	1
64GB够用吗	看书，浏览视频，下几部电影电视剧的话足够了。	1
玩大型游戏怎么样	没什么问题，虚荣这些高画质不会卡，这个配置玩什么都狗了	1
这个手机是联发科的，都说联发科玩游戏不行，那玩王者荣耀会不会卡，	还可以，就是很耗电。	1
3700买的到么	买不到 现在都是4000多	1
听歌音质怎么样？	音质一般，魅族都这样	1
买笔记本电脑送不送鼠标垫啊？	送了个鼠标垫	1
配件是不是原装的	不是	1
大家买过的老乡们好，手机上网快吗？	还不错，用两三个月后有点小卡	1
上网很慢吗？	备用机，平时不用它上网。但是连Wi-Fi时候都是正常用的。不慢	0
只能安电信卡吗	是的	1
机身厚不厚啊？	不厚，手感好	1
可以用电信的吗	你问问客服   我用的移动卡	0
上网可以几个小时呢？	上网，不停使用，12小时总能撑到的。这里普通使用，两天充一次电，新机子电池总归能用很久，时间久了就不定了，要续航你不如买个厉害的充电宝，爱用多久用多久。	1
是贴好的吗.	是贴好的单独还送了一个	1
电池能用几天！	大哥，都啥配置了还卡？有钱直接保时捷	1
里面的键盘顔色看评论为什么是彩色的？	那个是膜啊。。别买这种垃圾电脑	1
光驱吗，	没有光驱，如果要加光驱最好联系卖家。	1
是不是真的	真的，目前用着很棒	1
可以系统升级吗	可以	1
是机械和固态的双硬盘吗？	固态的硬盘	1
你们使用了小钢炮后，觉得可以配伴你们几年，	你买i7可以用十年？	0
是不是翻新机或者2手？	我觉得是正品，那些码都一样	1
掉地上，屏容易裂吗？	不知道，没摔过	0
和诺基亚6比起来该买哪一部？	诺基亚6，毕竟情怀摆在那，还有vivo和oppo一向是低配高价的，当然选择诺基亚你的要做第一批小白鼠	1
按键机身会掉漆吗	用到现在都还好的啊	1
女孩子，玫瑰金，金色，哪个好吖。	我觉得金色不过时    玫瑰金虽然好看   但是时间久了越看越不耐看感觉像旧的   反正我买的是金色的	1
手机好不好呀	可以，上点年纪的人用着不错。方向键小点，别的都还行。	1
有应用分身吗	有	1
我就想知道|通话声音清晰吗？	用了20多天，各方面效果我都满意。通话声音与前手机差别很大，这个效果真不错。电池四五天吧。但只能说明目前哈，因为用的时间不长。而且似乎现在价格涨了不少	1
耐用吗？	还好吧！你要想要我可以便宜买给你	1
有赠送什么	我的是3十32标配，1048元	0
920的显卡，能玩lol吗？	没问题	1
你好，我想问下手机电池容量是多少	3060	1
5.9英寸到底多大呀？	不算大，这个外框和平常5.5的差不多大小，女生用应该没有问题	1
好不好啊这手机	我是MOTO粉，一直用MOTO。这个价位MOTO不是性价比最高的，都是绝对够用，质量OK	1
这个不升级能用电信卡吗	电信4g卡可以用，但是只能用3g网络	1
可以直播嘛	可以，妹子你直播平台和房间是哪个	1
常用支付方式都支持吗	目前指纹支付一直用不了   别的没发现。	1
充电需要多长时间	同意楼上	0
移动定制机和非定制机有什么区别？	移动定制只能用移动卡，选全网通，电信移动联通三种卡都可用	1
请问亲们下水后还正常吗？	不敢下水其它没啥问题	0
是不是翻新机或者2手？	应该是正品	1
接打电话声音怎么样啊？	还可以吧。没有你说的内置软件之类的	1
想送我爸的，没用过OPPO，他就想能导航不卡，不容易摔，你们觉得怎么样	不错的手机	1
这电脑能蚂蚁花呗分期付款的吗？	应该可以。我是全款	1
这款配置用来学环境设计的东西可以么|	作为游戏本，这款配置是可以的了。至于学习环境设计这个，没有接触过，不懂。能用多少年是取决于用的人怎么样使用，有的人三四千的电脑能用五六年，有的人能在两三年内淘汰一台五六千的电脑。	0
分辨率这么低，可以看电视剧吗？	可以。	1
vivo和华为还有oppo哪个好	我更喜欢华为，这个买来送人的	1
用电快不	不快	1
3390的能玩gta5么？	不知道，我没玩过	0
能做充电宝吗？	不能	1
这店真假不知，	我本人没用过他家机子，帮两个朋友买过，两个朋友都没有不好的反馈，应该还好吧，买了一个国行一个美版	1
本人买的手机网上真伪查询，手机串号对不上。大家都有查过吗？	没必要的现在一般没有山寨机了，要是二手的机会也不大，因为这是新机刚出没多久不太可能下个鲁大师什么的，跑下分顺便也就能查设备是不是真机	0
不会是二手吧	不是安，手机还行	0
你们不觉得小米max的屏幕黑边有点宽吗？	就是   买回来才发现有黑边   有点不好看呢	1
这个手机有没有什么质量问题。	绝对正品	1
请问下支持移动4G吗？	不支持	1
摄影头和电影头哪个适合拍人像呀	摄像吧	1
还是本身自带root，	没弄过	0
有没有暗扣，	没有，就一些基本的功能，没有任何乱七八糟的应用。挺好用的。	1
显示怎么样？	鲁大娘显卡项得分144364	1
买过的都有送钢化膜吗	送的钢化膜不太合适，太窄了，因为这手机是有弧度的，	1
手机好用吗？	挺好的，用了一阵了，是正品	1
都少天能到	三天左右	1
是正品吗？	4G网可以到4.8M/sWiFi没注意看，我不打游戏的，看小说每天大概4个小时，电话多，可以用两天一夜留20%左右吧，正不正就不懂了，总体感觉不错	0
单机身不带镜头的话也可以拿来拍照了吧？	不行，必须配镜头	1
这个手机可以用几天充电	我要游戏看电视可以用一天，不玩游戏，不看电视用一天多	1
我就想问下有多少人买了	我也是49800，值得买照相比水果好	1
用起来流畅吗？	我现在用着呢！上网流畅	1
52O礼包是什么	都是些小玩意，三年售后服务值得赞	1
电池中度用能用两天吗？	不打游戏的话，差不多	1
大家的相机都开过机吗？	嗯，有开过正常的。	1
充电需要多长时间	拍照差，电池不耐用充电慢，音质想炸了它	1
这款手机插内存卡是不是存不上去吗？	存得上去！！喔下电视都是装在这上面的！挺好用的	1
有没包装盒？	有啊	1
怎样开机	和普通笔记本一样啊键盘右上有个开机按钮	1
手机电池怎么样	我看游戏直播感觉有点热 其他软件游戏用着还可以不热 电池正常使用一天一充 要是连续玩两三个小时游戏或看直播的话一天两充	1
可以告诉是这么使用的吗|	用力把快门按到底就会拍照了。	1
请问这是组装机吗？	不清楚 给爸爸买的 爸爸说很好	0
亲们，你们是不是才收到货手机上就贴了膜？	有膜	1
请问这款手机牌子的名字叫什么，	是个杂牌都没见过得	0
朋友们！此款双卡双待手机用的是标准卡（大卡）吗？	是	1
这个质量好不好啊，	暂时用着没有出什么问题	1
拍的清楚么	还可以 还可以	1
请问下大家这个展示机有问题吗，	值得买。小白觉得机器无瑕疵	1
买了以后送什么东西吗	鼠标，鼠标垫，一个手机，充电器，好像就这些吧	1
有没有暗扣，	没有吧，就是边上有两个按键，开手电筒的时候很容易弄到收音机	1
請問|尼康|d5200|拍風景和人物|配|35還是50好	室外拍挺好	0
请问一下是翻新机吗？	新的机子，像素很好，其他要做就有点挫了，毕竟不是智能机	1
卡过吗？	不卡，300的价格很值，我这个手机专门打电话有时候应急，不开网络不开wifi一星期不充电	1
可以打LOL么|	不行	1
手机好用吗	绝对正品，华为手机绝对好用	1
打出来的胶片是不是一次性的？	是啊	1
电脑会发出声音吗	会的	1
有蓝牙功能吗？	有	1
据说新的没有大黑边了，是吗？	是有比较明显我是银白色的，我个人要求不高，可以用，如果在意要灰色好点	1
亲们会不会觉得手机特别卡|	没玩过这个，不过我玩别的小游戏没卡	1
耗电快吗|	够了，充一次电一个月	1
像素咋样	这款游戏没玩，是正品，像素自拍发白，后置拍摄显冷淡。	1
是贴好的吗.	自己贴	1
手机有问题吗，	没有问题，正品 声音大小还可以	1
CF和英雄联盟特效全开会卡吗？	不卡，很流畅，两个游戏打起来都很舒服，就是键盘打cf 不咋适应，送的鼠标也很好	1
这手机能瞬间抓拍吗？	没有试过	0
还是要去照相馆洗？	相机名字就叫拍立得你说呢  哈哈哈哈哈哈哈	1
机身是玻璃的还是金属的？	玻璃	1
待机时间长吗？	四五天吧	1
值得买吗	挺好的，实惠	1
能定位吗？	没有内存卡，定位不清楚，可以问客服	0
富士和莱卡哪个好些？	和富士90一样，按下快门就出片。另外，这不是“打印”出来的。看过测评，徕卡无论是相纸还是机器，成像效果都更好，虽然相纸也是富士代工的。	1
我就想问他那个wifi为什么不能用	点这里或者fn+F4	1
同方电脑不是几年前就倒闭了吗？	去买联想吧，前怕狼后怕虎	0
有租他家的面罩吗|	没有	1
不会是二手的吧？	音质还好	0
用电快不	还行，只要不一直看电视了话能用一天	1
音质如何？	音质确实不好！不过我用他们送的华为的蓝牙小音响放的不错	1
像素咋样？	亲！手机是正品。像素有1300万以上。	1
几g网？	我没有用它上网，不好意思！	0
手机充电大家都大约多久能冲满	一点点都没有的话，两额小时左右	1
港行的手机大陆能不能保修？	应该是不行的	1
可以把系统改为win7吗	没试过	0
卡吗	系统内存多不多无所谓  主要是手机真的不咋地  千万别买  否则会后悔	0
是翻新机么？	一般、有灰	0
冲起电玩王者荣耀，卡吗？	我买了一台，目前运行正常	0
是不是翻新的？	翻新机是肯定的。基本很多电池和硬盘都是换过的。不影响使用，毕竟价格给力。没洁癖就买	1
手机外盒带塑封吗	有的	1
什么时候有黑色的呀	停产了   不会有了	1
是翻新机么？	全新港货，不用犹豫，我不是托，放心	1
全网通版跟移动版哪一个性能好，	一样的可能全网通信号好点	1
请问你们用sd拓展了么？	没有，我不玩游戏	1
|	不好意思，我是16g的	0
套餐一，二，三，四当什么意思啊	里面有写的！看自己需要拍。	0
套餐一，二，三，四当什么意思啊	里面的写的很清楚阿，你自己看需要的选吧	0
会不会卡机	是正品，万一出了问题去苹果售后可以的	0
是不是翻新机，	是新的用起来挺好的	1
好不好求真话	用不成，直接退货了！	0
是正品吗？	还好用，应该是吧！	1
问一下，内存32G的，实际内存多大？	23	1
颗粒感强吗？	我只能告诉你，我正在退货	0
有游戏么	这个还真不知道，给老人买的，我没看	0
新的有没有专业的验证码，	没有旧的成分吧，上面包装什么的挺新的。	0
我也挺喜欢翻盖手机的，这款手机到底用的怎么样？	还行	1
vivoy66好还是这个好？	这个，俩屏幕一样大这个是1080P，显示更细腻，其他配置都差不多，但是MIUI更易用些。	1
请问32G和64G除了存储大小之外还有什么分别吗？	当然没	1
说句实话，手机怎样？	手机真的不错！运行速度快，电池耐用！	1
有没有前摄像头？	这机子就是垃圾，我建议你买魅族5	0
对方能听清吗？	能听清特别棒	1
卡吗？	卡 电量挺好的	1
手机是新的吗	是的	1
遥控买不买好	比较方便	1
能玩守望先锋中等画质吗？	没玩过，其它软件电脑要有8G内存更好用。	0
后面是指纹吗？	是的，指纹解锁	1
带几块电池呀	两块。	1
运行内存到底多少	16G的2G，32G的3G	1
套餐一带鼠标和鼠标垫吗	我玩地下城游戏没什么大问题	0
晚上能拍么	可以的	1
请问亲们拉丝银白和拉丝深灰有何区别？	颜色不一样而已	1
中间建了以按吗？	可以，跟其它手机差不多，中间键可以直接退出，还可以当做指纹解锁识别	1
我在纠结选50mm还是sigma的30m？	用的是a6000	0
大家觉得慢吗	硬盘机械的5400转，内存4个g，能有多快，要想快加固态，上双通道内存	1
网上购买怎么办理分期	不清楚，没分期过	0
支持指纹解锁么	这才什么价钱，还想要这种配置呀。价钱不到，不会这么高端的。	1
4G卡能用吗？	能用，刚给我婆婆用上	1
这手机好用吗，	很不错的，玩游戏也给力，不发热	1
我买的是金色的，６寸屏，买的是给老人用，怎么样？	给老人用没问题	1
分辨率怎么样，	还可以啊	1
适合女性用吗	买n4，不要买n4a	0
开机画面是蓝天？	TF	1
这手机差评挺多的，会不会买到翻新机	不会	1
有发票？	有	1
内存64GB的是麒麟多少的？	高配版是955的	1
能玩王者荣耀码	可以	1
这个是正品么	是正品，蛮好用的	0
韩版是什么网络啊	我用的移动的	0
首字母调出联系人，	木	0
学生党一枚，喜欢打游戏，内存大不大	还可以，就是电池小点	1
游戏当中出现过吗？	暂时没有	1
各位电池耐用吗？	手机不离手，一天一冲。	1
屏幕有没有红线	不敢下水其它没啥问题	1
怎么激活	是5，用手机卡就可以激活	1
是原装正品吗？	是	1
是正品吗，	检测过是正品来的，到现在为止还没过	1
网络好不好啊？	我是觉得不错	1
指纹解锁是前置的吗	嗯	1
然而真的送32G内存卡了咩	现在不送了，我买的全网通，问客服要的	1
为什么买不到几个月，指纹键就不能用了，	售后免费解决	0
港版的6s背面下头有FC什么的吗	不知道，我买的大陆的	0
怎么有评论说连放个视频都磨皮，还有说屏幕发黄的，	色域不够，不过比破tn强多了，并不发黄	1
渲的时候卡不卡	cad2016还行	1
16g内存小的吗？	魅族就一次！	0
亲们，买来平时写些资料，做些PP，看电影，选择哪个套餐好一点啊？	我选了最贵的那个，容量大点，现在用着还不错	1
下载东西麻烦吗	看你下载什么哦！用流量的话虽然快但是很浪费哦！因为手机开数据连接的话默认4G网络，要下电影或者音乐就要先下载酷狗或者优酷之类的手机软件	0
套餐2玩游戏可以用多长	不清楚，都是小孩在用	0
这手机质量好不好	音质很好，就是用不到多少久就掉色。	1
不是官换机和翻新机吧？	不是，只是二手的。	1
有音乐吗	有音乐功能	1
可以设置双击点亮屏幕吗？	不行，只能指纹解锁	1
散热怎么样，	新款的散热很好。无需再买个体散热器	1
有自动开关机静音功能吗？	可以关闭声音，功能不少	1
note5|32G多少钱，	我的是3十32标配，1048元	1
请问是否支持快充？	?	0
前摄像头怎么样？	一般	1
遥控买不买好	买啊可以，难得手按	1
真的是0首付吗？	签收后按月还呀	0
运行是多少？	翻新二手机	0
电脑有没有什么问题	办公运行很快，得心应手。打游戏就不知道了	0
是全新的吗，	没太明白	0
玩游戏呢，	没有玩过，估计不是很好！	0
韩版是什么网络啊	网络取决于你自己移动联通234G全可以，电信不行，和港版相同	1
手机电池可拆卸，好吗	可以拆的，质量还可以	1
发热不？	还可以，发热肯定都有，它要热的话也很烫手，电池也还可以，有点小。它最大的特点是整机重量轻	1
有赠送什么	价格以店铺为主，价格幅度比较稳定，标配有手机膜，手机套，耳机。	1
有没有是翻新机的？	当然是真的，这个卖家可以信赖的，我跟他买的不是一台二台了，你需要什么机他给你什么机，零售机官换机都买过。	1
现在买xt1会不会过时？	不会，这又不是手机，而且成像的重点是镜头。当然xt2一步到位最好	1
玩蜘蛛纸牌会卡吗	别逗。。。问点正经的！	1
请问此手机是多少价位买的？	晚上买会便宜一点。大概一千四五就可以了。	0
亲，手机电池盖怎么打开	拿撬棍拗	0
玩游戏呢，	建议买红米4，我现在用的这个，玩王者没压力	1
请问国内移动信号差吗？	不知为什么 有时会掉到只剩一格火两格 但是不影响通话	1
是新的吗，	是新机	1
这款手机用大卡还是小卡？	大卡 不过卖家会送一套卡套 所以不用担心	1
真的是0首付吗？	我的是全付	0
要是下载几个游戏（如，	不玩游戏	0
像素怎么样？	翻新二手机	0
是指纹解锁吗？	指纹的 我的电信卡	1
请问港版的跟大陆还有美版的有什么区别吗如果没有那为什么价钱不一样呢	大陆和港版用都一样的！大陆的是因为国家要上税！所以贵一点！港版的不用	1
良心买家回答我的问题下这个东西是真的吗？	目前没有呢。我用的挺好的。拍照也不错啊	0
用着怎么样，	一般般吧	1
能做充电宝吗？	当然不能	1
怎么样	64够用了	0
是全新的吗，	手机保修貌似和销售商没关系，有问题找华为售后	0
看着指纹解锁在后背就软了，你们说呢？	不会，右手拿手机，设置食指就可以，感觉还是使用习惯的区别，我妹苹果忘记账号被锁机了，刚好那时mate9刚出来，买了一个给她	1
32版开机运存剩多少	只是开机运行，不再下载东西，是28	1
真的是正品吗|	是的	1
实物和图片一样吗，	是一样的	1
学生党一枚|打算买来画画cad|ug|proe|能带得动么	不厚不重刚刚好	0
未拆封吗？	还行	0
高清和超高清是什么概念，	清晰度可以	0
五千二那款开守望高配置会卡吗	会吧开中配没问题	1
3000多买这手机，合算吗？	看各人呢感觉	0
可以系统升级吗	可以，在系统设置	1
OppOR9KM是什么意思	这个我也不知道	0
屏是5.5的吗	5	1
想问一下买6+128的朋友，6g运存开机后还能剩下多少？	4G左右	1
外面的塑封膜还在吗	黑色外盒没塑胶膜	1
系统是否能在没有ROOT情况下进行后台自启管理，	自带安全中心的	0
机子运行怎么样？	是，运行还可以。	1
手机质量如何，	手机质量真的没话说	1
结实吗，	不知道，没摔过	0
是飞利浦正品吗	是，老爷子用不错	1
努比亚有几个按键？	一个开关机建，一个加减声音建	1
可以想智能手机一样点吗和手写吗	可以的，这个手机的老人从实体按键到触屏转化的中间过渡的手机，挺好的，想要按键就按键，想要触屏也可以触屏，等习惯了触屏的就给老人家换个全触屏的	1
电池耐用吗？	还没用呢。	0
请问32G和64G除了存储大小之外还有什么分别吗？	建议买64的，方便一点	0
店家不要说话！学设计PSCADSU可以用嘛？	不好，这款电脑只适合看视频，搞设计什么的还是去买n卡的吧，这款连lol都费劲，还有这家店耍小聪明，你要注意	1
骁龙板的怎么样	正品未拆游戏稳定不卡顿	1
手机是正版吗？	反正退货了	0
像素怎么样。	一般，这个价位也值了	1
有前置摄像头吗|	送人的，没注意看	0
这手机差评挺多的，会不会买到翻新机	不会   买起很好用      物美价廉	1
有租他家的面罩吗|	这家东西千万别租！ 相机有问题拍出的都有问题，带去马代全都白拍了两千多张，还怪镜头罩问题怪买家没清洁给自己找一堆理由	1
运行是多少？	一般，2G	1
是不是可以打电话	当然能打电话	1
可以想智能手机一样点吗和手写吗	可以的	1
确定只是拆封|未激活的机子嚒？	反正用到现在。没有问题。除了拍照声音关不掉。	0
能玩王者荣耀码	能	1
未激活的吗？	肯定全新未激活的啦，我买之前跟营业员确认过了这是苏宁官方自营的店，放心买吧。下单之后让快递寄到你离你家最近的苏宁易购实体店，到货之后你去取货，营业员耐心会很好帮你查看机器的外观是否有瑕疵，如果有瑕疵你可以不收货。快递员可就没有这么好的耐心等了。机器很好用，哈哈我之前的16G用着真是累。	1
耐摔吗？	没事不会摔手机玩呀  质量还行的！	0
我想知道那个两万多的有什么功能。	限量版，储存空间大	1
快门没了可以更换么，	有快门次数，但是估计你用不完。一看你就是属于刚入门被一群伪大神用快门次数唬住了。    不要想太多，正常有几个人用的完快门次数的，除非是商业需求。你能够两年内不喜新厌旧就不错了。	0
华为点才卖三千六百多，这个都上五千了，值得吗，	缺货把 我是上个月买的 已经4000多了 后面更贵	0
核实手机的信息从管网的哪里找？	网上查序列号	1
能用多久啊？	买了两次了 家里老人挺喜欢的 至少到现在手机没什么问题	0
7p韩版没买多久，摄像头突然打不开了，请问三哥怎么回事？	重启试试，不行的话找老板	0
我在纠结选50mm还是sigma的30m？	不知道为什么它文字的不让我发。补充一下，就是30mm镜头体积更大、较长，但我认为不影响～	1
r9s有没有跟我一样充电很慢的？	很快的，不知道你的原因，不过应该考虑换了充电头	1
你们用了多久了卡不卡？	刚买回来还没用，看着是一样的	1
手机玩王者荣耀卡吗	不卡，除非信号不好，玩之前要先清理一下垃圾	1
不是翻新机子吧？	是正品	1
系统更新后会不会卡	还可以	1
配件是原装的么？	原装不原装我不知道，但是查出来的确是正品未激活的。只是看版本还有型号的不同吧	0
预装正版win10么？	主要是色彩鲜艳。肯定不如72%的。但是影响不大。如果你是PS。设计的。就不要用了。玩游戏的没问题。	0
还有卡不卡，	不行，帮同学买的，用了一天就要我退货	0
7p韩版没买多久，摄像头突然打不开了，请问三哥怎么回事？	过完年找三哥吧，会帮你搞定的	0
比如王者荣耀开最高配置，会不会延迟，	不会	1
是华强北发的货。手机有没有问题啊？	可以给你明确，是翻新机，组装机	1
是全新的吗？	是滴	1
里面的键盘顔色看评论为什么是彩色的？	键盘是白色的	0
实体店要便宜些吗？	啥情况	0
送内存卡吗？	没有内存卡，定位不清楚，可以问客服	1
请问曲面容易误触吗	不会。	1
有返回键吗？	这是必须有的好嘛，和苹果是不同的，	1
插电信卡吗？	老人用的是移动卡 电信没试过 不过机子是双卡槽的	0
亲们，那个摄像头有没有很引人警惕，	没有，还可以	1
这手机屏幕是多大的？	6	1
样子笨拙吗？	不笨拙，看起来还可以	1
是正品吗？	正品	1
可以直接换屏保吗l	嗯	1
请问是64G还是64GB谢谢	64	0
赠品里的VR眼镜什么用啊？	并没有赠品，问就说活动过期了	0
现在销售的黑边改了吗	黑边有一点，不是太在意的可以忽略。我是觉得还可以。	0
卡吗？	我是MOTO粉，一直用MOTO。这个价位MOTO不是性价比最高的，都是绝对够用，质量OK	0
可以玩古墓丽影吗？	不好意思我不玩游戏，没有办法给参考	0
这手机差评挺多的，会不会买到翻新机	不会的，很好用	1
女生用银色好看还是玫瑰金？	玫瑰金	1
支付宝运行顺畅吗	一般	1
玩我的世界能加mod吗	没玩过耶	0
这机子和小米旗舰店的有什么区别	反正是正品背面有中国移动标志	0
请问下|这是怎么分期的？	不好意思，我不是分期买的	0
这款配置用来学环境设计的东西可以么|	不是电脑合不合适，是看配置说话。这配置挺好的	1
运行速度快吗	还可以	1
可以用电信的吗	不大懂这个，我家电脑是电信网，手机能用wifi上网，不知能否帮到您！	0
比三星盖乐世好吗？	完全秒杀	1
大家新机里的电池电量多少？	我的也是一点电也没有，一开始还以为是相机问题。。。	1
遮个办公用没有问题吧	一般的文档表格之类办公应该没问题，配置比这个低的也能用。	1
这个手机几寸的	5.5	1
摁键声音该怎么关	没关过，你可以问问卖家	0
用久了会不会有什么问题？	没啥问题把。苹果用着还不是出问题	1
vivo和华为还有oppo哪个好	个人觉得vivo好用些，而且6个g的运行内存，反应很快的	1
有6G+128G配置的吗？	应该有	1
日版的怎么样	我买的韩版可以，	0
值不值得买？	不卡，反正我用着挺好用的	0
我想问下买1080款的，更新最新版376.33驱动，会不会黑屏？	暂时没遇到过	1
怎么没有手电筒啊	没有	1
屏幕暖屏么？	应该是的	1
note3和5哪个好？	5	1
求真话|买过的亲如实说下质量怎么样？	可以啊	1
能不能看小说	要装内存卡才可以	1
为什么这么便宜？	你这语气，适合买五万左右的机子	0
散热怎么样|	用久了不太会发热，分辨率还行，1366*768	1
原装版本是哪个版本	10.1差不多最新	1
很大么？	没那么大了。看环境	1
屏幕有没有不平？	没什么问题，就是电量有点假的感觉	1
手机是薄款还是厚的	厚	1
守望先锋能带吗	额，秒杀，我才测试的最高画质没问题	1
大家人，说真的，好不好用，	不知道，给人家买的	0
套餐八的iPhone7plus日版有锁是三网通吗？	是的	1
日版的是不是激活了	激活不久的 我的一个月 用了1个月 没问题	1
多少G运行？	2g/3g/4g	1
是正品吗？	是原装未拆封，是正品	1
大家用过一段时间感觉怎么样，	还可以吧,发圆通	1
我已经有镜头单买机身行吗	可以的	1
接打电话声音怎么样啊？	能丫，以前的手机质量永远是NI.1	0
信号好不？	信号不错，智能机目前都差不多的，小米这个性价比不错了	1
请问大家电池耐用吗？	还可以吧，，好几天才充一次电	1
好不好用	真看不出来，反正我的不是全新的	0
问下这个手机怎么取消自动锁键盘的功能啊？	我也没有找到	0
手机是原装未拆封的吗？	是的  很好用  我玩王者荣耀很给力	1
像素咋样	开始玩的时候还好，后面嘛，你懂的	0
请问这款摄像小机器在晚上只有一盏日光灯的情况下，清晰度如果？	一般般	1
卡不卡。	可以，老人用不错	0
双卡双模是什么意思，	但是像素黑的时候拍 特别感人	0
怎么样	标配。	0
像素怎么样。	这个价格追求实惠吧。。这手机什么都好，就是无线连接有问题，时常密码要重输，搞的人烦死了	1
开得了4g流量吗	不能开	1
中间建了以按吗？	不能按，是感应的，用于做返回和解指纹锁功能	1
这手机怎么样。	不会啊，挺好的，建议买4G的	1
好不好用吗，	是正品，用了一个多月了，还可以	1
可以用几点小时	这个真没试过，不过短途还是可以的	0
大家觉得慢吗	3000多一点的笔记本就那样，看你做什么用，我下了个剑网3，玩起来一卡一卡的，根本玩不了，我买的时候是看中他的分辨率才买的，要是小米那款3500笔记本有风扇的话我就去买小米的了	1
hd6470丶hd7570和hd4000哪个强呀，	三个都没问题 如果硬要说最好的话 7570吧	1
这手机插卡就可以用吗？	可以	1
双卡双模是什么意思，	支持双卡4G	1
值不值买？	300多，和我去移动换的那台一模一样，可以了，移动卖600，到手至今未发现问题，做备用机，值得买！	1
佳能7D用这个头拍人像全身要距离多远？	近距不行	1
相纸十张能用多久啊	拍10张，一张一次，很快的	1
有没有发|票？	是正品的，建议买3g运行的，我的用的很好，游戏不卡	0
多少英寸	应该是4.7吧，和5s一样大小	1
亲们，你们是不是才收到货手机上就贴了膜？	嗯	1
日版的怎么样	还可以	1
还是要去照相馆洗？	拍了接着出	1
主看电影|分辨率会不会有点低	用久了不太会发热，分辨率还行，1366*768	1
你们都用什么镜头啊|	85	1
欧版能不能用电信的啊	nonono	1
真的是指纹吗真的吗？	可以	0
别的我也不懂，就想知道是不是正品，	应该是	1
粗磨屏吗	可以分期	0
风扇声音大？	没那么大了。看环境	1
手机好用吗|	还行	1
怎么这么便宜，	恩我买2400还可以啊用了有半个月了，一点问题没有，不错呢	0
会不会卡，	不卡不卡手机可以	1
这手机玩着会经常卡屏死机吗？	要是app控可能会	1
女生用银色好看还是玫瑰金？	玫瑰金	1
有游戏玩么	就一个贪吃蛇	1
国行？	但不是增值税发票	0
能删多少，	二楼正解，以前360OS附的天气是最美天气，个人比较喜欢，简洁精准，现在变成了墨迹，一堆的APP推广，一直恶心这个，看见墨迹俩字，第一个动作就是卸了它。    天气预报都能卸！不过桌面自带简易预报，这个插件卸不了。    不想要的基本上都能卸。	1
手机sin塞不住老掉怎么搞	金属片弯了，重新修正	1
到底有没有16G？	大概有12G吧	1
音质如何？	一般吧，还是那句话千元机别想它会有旗舰机的功能，有点小问题还是可以接受的	1
是5s吗？	是5，用手机卡就可以激活	1
机子怎么样|	我的收到已经没电，用了几天，显示循环充放电7次，也可能收到之前充过三四次，估不准。4日拍的，显示保修到明年1月2日	0
据说新的没有大黑边了，是吗？	灰黑更好！没有黑边只是将触摸玻璃白色加粗去遮挡早期的所谓黑粗边。视觉效果是好点！	1
像素咋样？	是用着还不错像素也还好	1
官网上799，这个是真的么？	真机	1
评论差评挺多的这机子真的好用吗？	性价比还可以	1
亲，是不是正品呀？	是	1
请问一下各位老板，配件是原装的？	是，手机很好	1
有用一年历史的人吗	有	1
送镜头盖吗？	必须有啊	1
手机用时间长了|卡吗|	不卡，这手机可以的，价位不高1000多点，性价比在这吧，我感觉不错，准备再买一台自己用不过送的蓝牙耳机不怎么样，毕竟是赠品	1
三摄像头是怎么回事？	前置1个摄像头 后置2个摄像头	1
它的实品是什么样的	就是价格便宜电池不耐用,和0PP0R9完全没有相似之处	1
有用了两三个星期的淘友嘛，	没问题	0
可以開什麼級別的特效？	可以 玩 我玩的很流畅 全特效 就是电脑热得快	0
是全新的吗？	是全新的    送我呗	1
好用吗	还行 最主要的是可以diy 但是拆机是个考验diy者	1
电耐用吗？	一般，这个价位也值了	1
好不好用	新机子，用着还行吧	1
note3和5哪个好？	红米好，毕竟价钱贵，5才7000	0
请问字体大吗？	有点小，但可以调吧！	1
用大手机卡还是中卡小卡？	反正不是小卡	1
手机外盒带塑封吗	有的	1
接打电话声音怎么样啊？	这个手机不建议你买，我买完就后悔了	0
支持指纹吗	不支持我买的红米4不到一个月手机屏幕直接按不动就像死机那样直接没反应给商家返回去维修今天还打电话说是人为的把主板农坏了要维修费呢如果想买的话就找和售后好的买这家售后不好货也是山寨的假货希望能帮到你	1
这个是全新原装的吗	原装最新版，12月份生产的，系统也是开机最新版。	1
反应快不快|	还行，就声音太小	1
电信4g卡能用吗？	能	1
这是智能手机不	不是	1
续航怎样啊，	正常的话是两天一次，不玩游戏，完游戏一天一次	1
请问相机底部封条开封了没？	好像封条没粘性，但我尝试从底部开盒子，是会破坏盒子的	1
请问一下，这款电脑，玩游戏怎样？	小游戏可以的，大型网游估计不行	1
128G够用吗，	我够用了，应为我买来看电视的	1
是原装正品吗？	是原装货	1
X9好还是这个play6好	配置方面还是XP6好	1
手机卡吗？	新的，指纹解锁，看着没什么问题。	1
卡不？	很好用的，全新未拆封，可以当面拆开的。电池要是3000以上就更好了	1
用着手感怎么样	挺好的	1
手机怎样？	手机还不错，电池也耐用	1
男的用娘么	女生用黑色，汉么？	0
玩王者荣耀|全特效会卡么？	不会卡的这点可以放心	1
使命召唤13全特效卡吗？	还好	1
有手电筒吗？	没有手电筒，没有耳机孔	1
6X跟OPPOA37哪个好些	6x有内存3g  和4g版的，我买的3是3g 的玩游戏还行。OPPO 没用过不作评价	0
可以玩阴阳师吗，	卡	1
像素咋样	我不玩游戏 只是看看小说 看看电视剧 看个新闻啥的 自己觉得足够用咯	0
这款手机到底好不好	可以	1
亲们，买来平时写些资料，做些PP，看电影，选择哪个套餐好一点啊？	比新的肯定划算，我现在想买个苹果	0
电池才3000毫安，续航是不是很差，	还好吧，一天还是没问题的	1
可以自己插内存卡吗？	可以	1
夜晚手机屏幕除了指纹有反回键吧？	有	1
怎么激活	我买的就是5s用减小的手机卡就可以激活	1
能甩地上吗，	废话	1
这手机1万人民币，有什么优点么	自己去看	0
拍视频的话哪个更好点	我能说买回来还没用吗	0
我的玩个保温萝卜都卡的半死|什么情况	没玩过这个，不过我玩别的小游戏没卡	0
手机电池可拆卸，好吗	应该可以吧。送朋友了。速度还行	1
能照相吗？	不能	1
请问这款手机能连WIFI吗？	不能	1
选哪个套装合适呢	哈苏。这是站在同一个位置拍的。	1
是不是卡贴的	是不是卡的不清楚，成色还是很新的	0
相纸哪里买？	没懂啥意思	0
检测是翻新机吗	没检测过，我老爸用这还行	0
听说这个玩酷跑会卡|说是CPU很低|真的吗	没有发现卡，可以啊	1
5.9英寸到底多大呀？	比5.5的大一点点，个人觉得不算大，一个手可以拿下	1
3G＋32G拍哪一个，	办公什么的就3g+16g，如果要玩游戏还是建议3g+32g	1
三星c9pro是正品吗？	是的是真品	1
流光金和琥珀金那个好看	都好看	1
运行有多少	还行	0
是原装的嘛	可以没问题不是翻新机	1
可以作为主机用么，	电量确实不尽人意	0
ps会卡吗	有点	1
没有插这个wifi卡|就链接不了wifi吗	wifi卡是用来穿照片到手机的 没插WiFi卡就不梦连接WiFi上传照片	1
内存怎么样，	像素还行，电池不是很好，这手机反正我没用了	0
是不是翻新机？	不是翻新机是真机  2g运行	1
64g实体店有卖吗	很少有   一般只有32G的   如果需要实体店可以给你拿	1
佳能M2能用吗	佳能都是一样口，买的时候选佳能口就。	1
卖家发的什么快递啊？	信号不太好，其他都很不错	0
好用吗？	好用	1
就是一开机有多少运行内存啊	我用的是低配3+32G的	0
拍照会闪退吗	不会的	1
就是玩反应快吗那么卡吗，	不卡好向手机是2G网络的	1
手机是全新未开封的吗	是的	1
那里面有没有剪卡的，	没有 自己去营业厅办理的	1
欧版能不能用电信的啊	不能！建议买美版！便宜！支持三网	1
玩游戏卡吗？	不卡不卡手机可以	1
差价这么大，值得购买吗	还可以，送人了还分手了	1
送人的话怎么样啊	是滴	0
这款三卡三待的手机，能不能同时放两张电信卡？	没试过应该是不能	0
联通卡能用	全网通的可以，双网通的也行，只要不是电信版的，你可以问问客服。	1
会不会出现内置软件乱收费情况呢？	还可以吧。没有你说的内置软件之类的	1
为什么sim卡卡槽那么小？	去营业厅换卡	0
高配的4g的运行内存，实际能有多少能用，	用的3G，	0
是正品吗？	还可以啊，使用起来感觉挺流畅的	0
能换壁纸吗？	还可以，有点长	0
用起来卡不卡，	还好，给老公买的，他的要求不高，还帮他同事买了一个，都挺满意	1
大家都买的什么颜色的？	亮黑	1
z5好还是xz？	不是一个感觉，旗舰还是z5尊崇版的，xz是去年新上市的手机版，可以对比看看感觉，如果喜新厌旧就xz,如果想找索尼的感觉还是z5大屏版，经典的外观	1
和|iPhone|7哪个好	没有用过iphone7	0
前摄像头怎么样？	一般，毕竟价位在那摆着，而且我是买给老人，对这个功能不在意	1
充电器是快充吗	充电很快	1
大家用过一段时间感觉怎么样，	比国产的好多了，我的发顺丰	1
moto|z有NFC功能么	有	1
感觉质量怎么样？	还可以，没坏的	1
这个是正货吗？	是正品国行机，但是啥都没有送的	1
请问电脑的密钥在哪	我从来不锁电脑的	0
检测是翻新机吗	其实后来想想，买个水货苹果5才这么多钱，那肯定是翻新机。所以想买个新的，金立广告打太厉害了！不知觉的就选这款	1
还是二手的	有新的，也有二手	1
是不是翻新的？	值得买。小白觉得机器无瑕疵	0
我就想问下有多少人买了	我买了 5300买的 一个月不到 现在居然涨那么多 醉了。。。	1
请问一下|是不是组装机	是的，但用着还行，系统是苹果的，有些功能和真机不一样。	1
耗电吗？	卡 电量挺好的	1
用多久了	一般般吧	0
好评好多啊？不会是刷的吧？	不是的，我买的特别好用	1
容易碎屏吗，	注意好，应该没事	1
我充电不了怎么办啊？	可以退货啊  问卖家	1
华为点才卖三千六百多，这个都上五千了，值得吗，	其实也就3600多吧，炒的，等段时间就行了	1
这手机给老婆用好吗？	可以啊，玫瑰金我感觉挺漂亮的，尺寸也刚好，建议入手y67,运行内存大还有指纹解锁	1
耐不耐电？	还可以	1
预装应用有多少，	除了主要功能其他都可以删	0
请问买官方标配送屏幕贴膜吗	不送，就是官方标配的那些东西！其他需要的可以单买。	1
手机怎么样长时间卡不卡？	玩游戏会有点卡	1
高配4+32的好吗？	是，电池还耐用，我的是3+32	0
是全新的吗	是全新的。电池耐用。个人观点。	1
请问国内移动信号差吗？	假货来的	0
信号好不？	不错	1
中间的home键能按下去吗？	不能按下的	1
我怎么刚买了前置摄像头拍照不是模糊是根本什么都拍不清	你的前置摄像头上面是不是有一层膜啊  把那个给揭了	1
是正品吗，	是正品，万一出了问题去苹果售后可以的	1
大家有出现过触屏不灵的情况吗？	暂时没有	1
增强版玩大型游戏卡吗，	不知道，我买的套餐三，用着很不错	0
电量耐用吗？	一般就ok	1
手机卡不卡？	一般，2G	1
像素怎么样。	可以很好用	1
CF和英雄联盟特效全开会卡吗？	一点都不卡	1
请问怎么切换4G的开关	切换？本来就是4G手机啊	0
这和10999的gt62差距在哪里	区别很明显，请仔细看内存和硬盘	1
大家用着怎么样啊？	还好，感觉还是加固态硬盘好用点	1
请问美版64g的型号是1687吗？	这个我没有具体查，我用的是16G的，个人认为，它毕竟只是一部手机，不能替代笔记本等等，所以16G足够了！仅供参考啦哈	0
相机像素怎么样|	同意楼上	0
值得买吗？	没有用过，我买的是美版的，手机用的很放心，这个价钱买苹果真的是值了，目前没有什么问题，很好用	0
真的是0首付吗？	是的，0首付	1
请问移动卡可以吗	全网通啊！什么卡都能用的。	1
是正品吗？	还行	0
是正品不，	我喜欢灰色，男的。	0
打电话给别人，有杂音吗	电池能用半个月	0
玩起来会卡吗？	还好用，应该是吧！	1
是不是翻新的？	用了四个月感觉还是新的一样，买那个未激活的版本贵点，电池循坏我买的时候是0次，反正没啥毛病	0
真的能连wifi吗	可以的	1
还是本身自带root，	可以，但root了之后没得保修	0
分多少期付款	12	1
有这么多官换机么？	有病	0
然而真的送32G内存卡了咩	没有	1
评论差评挺多的这机子真的好用吗？	还行	1
还是要去照相馆洗？	是的	1
是第几代	三代	1
内存64GB的是麒麟多少的？	955	1
来电，通话声音都怎么样买过的亲们麻烦告知一下真实情况，	一般般	1
这手机内存是不是真的？	用了三天，就不行了	0
和小米4s区别大吗？	自拍还是别的手机，这款手机相当实用	0
原力金，一个软件不开，有多少运行内存	没注意	0
亲们，S7的前拍怎么样，	前置摄影头不错，带美化效果	1
朋友们！此款双卡双待手机用的是标准卡（大卡）吗？	对	1
系统是否能在没有ROOT情况下进行后台自启管理，	有，基本和一般安卓机root后权限一样	1
摄影效果如何？	全新港货，不用犹豫，我不是托，放心	0
14天？	我的不是，查询是瑞士定制版黑色，不过商家把壳子换了，但是真会没问题。	1
感觉质量怎么样？	用起来不方便	0
打出来的胶片是不是一次性的？	我的卖给你，就拍过6张照片，其余的都在，包括净化器，700块！	0
电池中度用能用两天吗？	不玩应该可以吧。	1
亲们，是正品吗？	应该是正品，用着挺好的	1
这款电脑送电影适配器吗	没听说 什么是电影适配器	1
请问你们安联通卡怎么设置的	我用的电信卡	0
屏幕是多少寸的	15.6	1
会不会卡？	不知道啊 我买的32G充新机 机器挺好没有划痕 用着不会卡 挺快的	1
是不是问题特别多	很不错的，玩游戏也给力，不发热	0
卡不卡，	我老公就是买来玩游戏	1
内存大吗这个	有16G的	1
像素好不好？	像素不好，千元机水平，没玩游戏的情况下重度使用不发热，一两小时左右没注意充电时间。续航不错，整体很满意！如果不是很在意拍照的话强推这款。如果你需要拍照加钱买个贵点的吧	1
适合女性用吗	还不错啊 可以用	1
它的实品是什么样的	什么？实品	0
值得买吗？	还行，我用着没问题	0
手机好用吗	应该是正品用了半月没见毛病	0
有发票吗	发票没有，我要了，说有但是没有发给我，是正品	1
请问9s怎么分别设置两张电话卡的来电铃声	我只用一张卡，不知道	0
是否翻新机？	他们说是翻新机	1
纸买多大的呢？	就是一种型号吧	0
搞个手机套会不会呢	贴了钢化膜，套上手机壳，摔了好多次都没事	1
屏幕泛白？	我也是买半月了用着挺好的	1
怎么分期付款？	点击立即购买，然后选择自己喜欢的型号，再往下拉有一个花呗分期，选择想要分期的期数，然后就ok了	1
运存多少	10	1
有没有什么质量问题谢谢	目前没有呢。我用的挺好的。拍照也不错啊	1
屏幕边缘有缝隙吗	没有	1
卡吗？	一个多月了！感觉还好不怎么卡	1
手机好么？	还不错	1
你们都买多长时间了，	帮别人买的	0
外观怎么样，	用了四个月感觉还是新的一样，买那个未激活的版本贵点，电池循坏我买的时候是0次，反正没啥毛病	0
耗电量，和系统流畅度怎么样！	电量确实不尽人意	1
阳光下能看清屏幕吗？	没用，不好	0
游戏当中出现过吗？	暂时没有	1
这个手机有没有什么质量问题。	给老妈买的	0
实体店要便宜些吗？	标识价格一样的	1
怎么感觉有点卡顿？	卡的时候,刷次机就ok啦	0
能照相吗？	不能的，只有可以播放的三字经什么的	1
官网上799，这个是真的么？	真机，	1
指纹解锁是前置的吗	是的！你要我的可以便宜卖你！我想入手2017	1
是山寨机吗？	正品，开机八秒	1
韩版是什么网络啊	电信不行，别的挺好的	1
能不能触碰？	不能	1
会不会死机黑屏什么的	我只能说，买了很后悔，我当初就是图便宜了	0
烧主板吗	我刚买了十天，暂时没有问题！手机也很流畅！不过给店家给我发来的机器貌似已经ROOT了！wifi信号没我的LG平板强！烧主板应该不会吧！	1
买了大概多久可以收到？	是正的，3天	1
玩王者荣耀卡吗	还好吧！别总是玩大游戏一般用足够	1
反应快不快？	新手机刚买来都挺快的	1
是几寸？	6	1
能用4g网络吗	不知道，我买给我爸爸的，他不上网。	1
手机外盒带塑封吗	未拆封	1
开热点网速快吗	我不玩网游	0
怎么看外观插槽跟我那平板差不多啊？	上网本，好用啊，速度可以，我是用于某些设备调试时传输数据	0
还有是否能玩《gta5》？	没问题 放心玩 不过本本跟台式还是有差距 要有心理预期	1
机子运行怎么样？	挺好	1
请问电动饼干头与12-50镜头有什么区别呢？	日常用电动饼干就行，12-50多了一个微距而已，看个人了。	1
你们玩英雄联盟FPS是多少最贵的那个套餐	店家说穿越火线可以玩，刚来的时候没有联网没有玩，一个月后联网玩CF  卡的很，现在没有办法退货了  觉得买的贵了	0
想送我爸的，没用过OPPO，他就想能导航不卡，不容易摔，你们觉得怎么样	还行	1
亲们这款手机怎么样	老人机	0
用老黑莓信号超强，这款如何？	信号不是太好，但不影响接打电话，接通速度稍微慢点	1
充电大概高多久啊	充电很快 2小时充满	1
声音大吗？	智能机，就算没有也可以下载，声音大！	1
一般用法能用几天？	两天	1
请问下是啥版本？	我买的骁龙版的4+64G	1
能看小说吗	不能，不过能从电脑上下载歌曲	1
我充电不了怎么办啊？	我的可以充	0
晚上玩手机屏幕是不是刺眼	什么手机都一样的，开暗点就好了	1
骁龙821四核和骁龙625八核哪个强	821，有疑问？	1
这种像素怎样，	是正品，使用正常。	1
是正品不，	正品 月光银没有他们说的那么难看	1
耐用吗？	不知道。反正都那样当备用机可以的	0
自拍有没有美妆功能	有啊	1
哪个费电啊	我的是E，别买好垃圾的，反应的问题没人受理，而且寄去维修了一个多月	0
这款是新的吗？	二手	1
官换机什么鬼	64g。     但是连耳机都没有	0
屏幕泛白？	没发现什么问题，还好。	1
适合有点耳背的老人用吗	老人用的话不推荐  智能机音量都不大  可以买老人专用的那种手机  价格比这个也要便宜  那种的音量和按键都比较大  比较适合老人用	1
这台电脑厚重么|	个人感觉不厚。	1
能不能触碰？	不能	1
后面是指纹吗？	废话，	1
请问续航大概多长时间？	还没有完全放电过	0
亲们这款手机怎么样	买给我爸的～～～	0
待机时间长不长	可以用，待机还可以	1
能剃须吗？	大哥这个是手机啊	1
是不是可以打电话	能打电话	1
这件笔记本，续航时间多少？	还没测试呢	0
内存怎么样，	可以很好用	1
手机按键按起来反应快吗，	没有，感觉还可以！	1
可以玩阴阳师吗，	没玩过	0
手机总是会重启吗	用了两个多月还没有出现什么毛病	1
分辨率怎么样，	我只能告诉你，我正在退货	1
S7和C9哪个好	s7	1
卡不？	电量用的有点快	0
请问真的是官换机吗？	当然是真的，这个卖家可以信赖的，我跟他买的不是一台二台了，你需要什么机他给你什么机，零售机官换机都买过。	1
尼康D7200好用吗	还可以吧，我用的D7000	1
为啥有送那么多东西？	送东西可能是策略吧，比较吸引顾客吧，不过确实是正品	1
手机是原装未拆封的吗，	我的是4+32还不错，用了仨月没卡过	0
这个机子的性价比怎么样？	还行吧	1
耐用吗？	还好吧。	1
玩蜘蛛纸牌会卡吗	我说会你信？	1
3000多买这手机，合算吗？	你要是用惯了魅族，就很不错	1
能玩守望先锋中等画质吗？	没玩过，我玩极品飞车17，还不错	0
请问这个手机是原装未拆封的吗？	是的很好用	1
大家用得可以不？	用得非常好！	1
手机可以用流量不	屏幕太小，根本没法用！	0
像素够用么	够用  还可以值得购买	1
比三星盖乐世好吗？	必须的！太流畅了！安装软件也不三星牛X	1
录像是有声音的吗？	是的，我在5米左右都能够听清楚	1
声音大吗？	声音大小由你调，机子很好	1
我看评论里面有人说拍了灰色发银色，买过的说说这家店怎么样？	我的就是灰色发的银色，不过银色并不能说丑	0
可以玩守望先鋒嗎？	可以 玩 我玩的很流畅 全特效 就是电脑热得快	1
这机子用时间久了，会不会掉漆	不好说	0
正面是白色好看还是黑色？	两个放一起还，一眼看中黑色	1
怎么解决	没有	0
请问这款笔记本有散热风扇吗？	好像没有	1
运行与储存空间多大？	我买的骁龙版的4+64G	1
高配的4g的运行内存，实际能有多少能用，	我用的是低配3+32G的	0
有买过韩版的嘛|	港货	0
可以设置双击点亮屏幕吗？	好像没有有指纹解锁	0
看视频好吗	不建议做主力机使用	0
会不会用了几个月就开始卡	我不是重度手机玩家，装的APP不是很多，多了就占运行内存呗，时间长了肯定卡呀，没事清理清理垃圾，2～3天重启一下，我觉着就挺好，反正我挺爱惜的，土豪可以随便折腾…	1
root后好用吗，	不翻墙可以用各种国内市场啊，也可以电脑装软件啊。没必要root现在不是玩机的没什么root需求。全家桶必须好用啊，前提你有网就可以	0
信号如何！	信号不是太好，但不影响接打电话，接通速度稍微慢点	1
美版不能关机充电吗？	我也没有试过	0
充电指示灯到底亮不亮？	不亮哦	1
这个手机不是在京东和官网才买的有吗。这边的是不是真的哦。	淘宝不比京东厉害	1
是正品吗，	内存还可以吧，主要是像素挺不错的，是正品，我买个一个月了，总体感觉还可以，	1
不可以用4G？	3G	1
准备年后推新品了？	不知道呀	0
这款好用吗？	还不错。调个色，成品自己看吧	1
你们的有过无线网络不能连接的问题没？	重启	0
我看评论里面有人说拍了灰色发银色，买过的说说这家店怎么样？	我買的摩卡金的	0
而且反应也有些慢，怎么这么多问题	没问题啊玩游戏啊什么的OK	0
d7100配这个头的话，会跑焦么	亲，应该不会哟	1
还是二手的	新的，99新那种是柜台机	1
有跑焦么	到目前为止还没发现	1
日版的怎么样	日版的也还不错啊用起来没什么差别，我买美版一个自己用，帮朋友买的日版的	1
时常断吗？	没有。还行	1
玩久了会不会发烫？	不会	1
这是笔记本还是上网本啊，	只是我的现在都开不开机了	0
水改行？	不知道，用着挺好的	0
旗舰店都没有送，东西和旗舰店一样吗？	一样的，是正品	0
韩版呢	我才发现美版不能关机充电	0
亲们，想问这款手机信号怎么样，	挺不错的，用了好久，没发现不好的地方	1
声音大不大啊	没有问题，正品 声音大小还可以	1
什么手机	还行，就声音太小	0
不是山寨货吗？	不是	1
能看小说吗	不能	1
请问喜欢拍风景和微距的选哪个套餐适合？	拍人物和微距么定焦的镜头好些。风景么广角镜头好些。要求高么后期自己再买镜头配。你要是不太介意么，套餐5的两个镜头也能凑合用。	1
玩蜘蛛纸牌会卡吗	卡的你想揍自己脑瓜子	1
配700d的机身，成像有缺点吗，	好镜头，原装的	0
请问美图好用还是卡西欧？	美图挺好用的	1
未拆封吗？	他们说是翻新机	0
有赠送什么	我是比较早买的32g999然后送了耳机钢化膜手机壳嗯怎么说呢？除了手机壳其他都很垃圾要自己买	1
这个手机可以用几天充电	差不多两天，不过我建议你还是到实体店买，网上太多假的，我都感觉自己上当了	1
不是翻新机子吧？	放心买啦！没问题的，我都帮我同事买了五部了!	1
怎么有评论说连放个视频都磨皮，还有说屏幕发黄的，	45色域ips屏，总比那一堆垃圾tn屏好，就是生产商不是lg，是京东方而已	1
手机好用吗？	没有问题	1
你们的下水过吗？	谁没事闲的？	0
可不可以拓展内存	不可以，64g应该够了吧	1
双卡双待，是一张手机卡一张内存卡吗	的	0
插电信卡吗？	是的	1
我一直在纠结买x9还是r9，各位前辈用得怎么样，	r9s	1
卡不卡？	64G的，一点都不卡好用，游戏特流畅！	1
不会是组装机或者翻新机吧？	不会，还是值的买的，我买给我老婆的生日礼物，这个价位还是可以的，用起来也很好，我也是第一次买，以前用的都是国行，价位又高，你懂的	1
SE停产了没？	不知道	0
待机时间长吗？	挺长的！我是帮朋友拍的	1
这款和小米比怎么样啊	还行吧	1
手机一开始都没电吗？	关键是吸话费	0
能放心购买吗？	我买了两个，都挺好的，但是不能代表所有的。自己看吧，反正也不贵	1
实体店要便宜些吗？	应该能便宜1*200块	1
手机怎么样长时间卡不卡？	挺好的 用到现在一直很流畅	1
你们买美版的充电器是三角头的还是两头的	有转换头！	1
到底有没有16G？	没有，只有9G多	1
玩王者荣耀|全特效会卡么？	应该会卡的  这个手机不玩游戏也有点卡	1
用大手机卡还是中卡小卡？	中卡	1
不是山寨货吗？	不是，东西挺好的	1
拍摄的时候要亮吗	拍摄时可以关掉LED显示灯，夜视灯是不亮的	1
钢化膜是全覆盖的嘛？	差一点	1
怎样知道是不是正品？	正品	0
买什么玩LOL不卡	买什么，玩LOL都不卡	1
请问美图好用还是卡西欧？	美图	1
电脑会发出声音吗	发	1
是指纹解锁吗？	是指纹解锁的，港版还好啊	1
买了有什么不满意的吗？	挺好的，孩子特别喜欢	1
可不可以分期付款，	花呗可以分期，	1
夜晚手机屏幕除了指纹有反回键吧？	和R9一样	0
SE停产了没？	会降价的	0
|	手机用起来挺流畅的，没问题！	1
机子是不是翻新的	我覺得是	1
手机一直亮着不会黑屏，你们有这种情况吗，	没有	1
正面是白色好看还是黑色？	白	1
求真话|买过的亲如实说下质量怎么样？	还没用呢。	0
有人说这本子屏幕灰白，处理txt文档时字都看不清，不知是这样吗？	我觉得还可以啊	1
love白|套餐一|有没有送的	都有啊	1
在这买手机可信吗	可下载鲁大师软件，就知真假的	0
请问怎么切换4G的开关	手机挺好的就是我才买了一个多月，就被小偷偷了！	0
手机能插电信4G小卡吗？	大卡	1
日本的怎么样|	还行，我用着没问题	1
能插普通那种大sim卡么？	建议你不要买，没用，真心没用	0
你们买的都不给手提包和鼠标吗？	键盘淘宝价89。他们送的价值600的礼包我也是醉了，鼠标最多值5块钱。双肩包兴许还能值100	1
是翻新机麽？	我用着还好，是自己激活的，样子很新	1
hd6470丶hd7570和hd4000哪个强呀，	虽然很差的独显，但是lol还是没问题	0
送内存卡|这款手机可以插内存卡吗	可以	1
性价比怎么样？	这款比你说的那些强太多了，你可以自己上网看看测评	0
请问这个手机是原装未拆封的吗？	是原装未拆封，是正品	1
用起来怎么样卡吗？	是新的用起来挺好的	1
本人买的手机网上真伪查询，手机串号对不上。大家都有查过吗？	没有查过。	1
手机是原装未拆封的吗，	全新的，我买的3+32，很流畅	1
x9带分屏么，	这个不太清楚	0
铃声是什么？	普通音乐，别买了，不好使，我的买回来还没用就坏了。后来我买了他们家另外一款198块钱的还不错	1
玩那些辣鸡游戏买个这本子的脑子没问题吗？	毛病很多，不推荐购买，真的	0
请问一下大家，这款电脑玩《守望先锋》开最高清晰度，	没问题 放心玩 不过本本跟台式还是有差距 要有心理预期	1
卡不卡？	还行	1
有nfc功能嘛？	经常自动关机重启，不好用，谨慎购买	0
你们玩英雄联盟FPS是多少最贵的那个套餐	玩游戏就是卡，	0
能放心购买吗？	我帮我婆婆买了一个用了好几月了很好用	1
怎样辨别手机是否是正品	手机用着还可以	0
手机大小有手掌大吗	有的	1
电板可以拆吗，	完美运行，我感觉还可以	1
亲们，买来平时写些资料，做些PP，看电影，选择哪个套餐好一点啊？	我这个卖你，刚刚买两个月要不，	0
好用吗	新款的散热很好。无需再买个体散热器	0
质量如何？	一般、有灰	1
能连无线不？	肯定能啊，	1
又想出的么	有 需要吗99新哈 需要加卫星：leiwen935	1
能用几年	作为游戏本，这款配置是可以的了。至于学习环境设计这个，没有接触过，不懂。能用多少年是取决于用的人怎么样使用，有的人三四千的电脑能用五六年，有的人能在两三年内淘汰一台五六千的电脑。	0
又想出的么	低价转白色99加新	1
我是8月17购买的，之前开机也显示中国移动有个4G标志，现在变2G了，怎么回事啊	手机桌面顶部下拉，长按4G依次选择～自动选择432G.当你所处位置有什么信号就会自动选择最佳网络，老家基本是2-3G.	1
多大的运行	一几的	1
卡吗？	便宜机马马虎虎。性价比高还是ZUK	0
有没有出现卡或者死机的现象	目前没有	1
请问电脑的密钥在哪	登录的话起动娜娜会要求你注册一个msn的邮箱注册后就用这个账号登陆	0
用了过后有什么问题吗	不好，不如A7，刚买没十天。卡的死了，打字都特卡	1
港版新机未激活的情况下自动关机，这正常么？	老是重启？还是怎么的？我是国行的，10月买的，用到现在没毛病	0
电池…如何	充电超级快。	1
请问美图好用还是卡西欧？	别来美图福多多这家店买，坑的一匹啊	0
是正品吗？	没有，	0
到底是不是正品，	好用！不卡！挺好的	1
套餐2玩游戏可以用多长	没有试过，看电影，快两个小时左右	0
这款笔记本1366x768的屏幕看着怎么样啊	挺好的。	1
请问一下大家，这款电脑玩《守望先锋》开最高清晰度，	可以玩，但肯定比台式机差	0
像素咋样？	亲，手机是正品哦	0
你们买的都不给手提包和鼠标吗？	给了个很便宜的鼠标和键盘膜，还有就是好评后会给键盘	1
这手机好么	看谁用，	0
日本的怎么样|	没有用过，我买的是美版的，手机用的很放心，这个价钱买苹果真的是值了，目前没有什么问题，很好用	0
各位电池耐用吗？	挺好   的  待机时间还可以   智能机待机时间都差不多	1
会不会很卡	不玩大游戏，别点那么快，就不卡	1
机身不防抖的机子，是不是买个防抖的镜头，效果都一样？	防抖的有多大效果我不知道  但是自带的镜头如果不用三脚架 拍出来的照片放大看的时候还是会有一点抖动造成的模糊现象	0
你们都买多长时间了，	买回来没几天，用的很少，所以暂时还没发现什么	1
语音助手和实时翻译功能可以不联网使用吗	打开一些软件可以 翻译好像不行	0
夹在公路自行车把上，小震动颠成shi了，一点也不防抖..有啥解决办法没？	不知道耶，没试过	0
卖家发的什么快递啊？	比国产的好多了，我的发顺丰	1
有没有用了很久的人|	好用啊，家里一直在用没有发现哪里不对的地方	1
是全新未激活正品吗，	不会是翻新机，放心	1
乐2pro爵迹版总统怎么样	还可以	1
充电多久能充满	个把小时就满了，快充	1
是战神z7m好呢还是炫龙炎魔t1pro好呢怎么选啊	i7四代和六代核心，显卡一样，内存都是8G，一个固态128G一个机械硬盘1T，个人觉得SL7好，如果想要固态硬盘回来自己加也用不的多少钱，还是看自己需要吧	1
真的可以买吗？	买了两次了 家里老人挺喜欢的 至少到现在手机没什么问题	1
手机好不好呀	好呀	1
华为畅享5屏幕反应不灵敏，需新息屏后从新解锁，打字还打错！淘友们你们有这种情况吗	没有	1
担心翻新机	放心买吧我用了一个多月没问题都查过了正品	0
自提有赠品吗？	不支持自提	1
不是翻新机子吧？	是正品	1
怎么样才能拍的好看	不知道	0
它是发的顺丰嘛？	手机用着不错  用了一个月了没发现什么问题	0
卡怎么放	放在卡槽里	1
是全网通，全4g的吗？	是全网通4G 内存有25G左右可用	1
做工、质量好吗？	通话清淅，定位准确，很好	1
美版和欧版是翻新机吗，	我的很好	0
这个发票具体的公司是哪家公司？	广州市伟联科技有限公司	1
这部手机能识别二维码吗？	能啊	1
就是一开机有多少运行内存啊	用的3G，	0
是什么布料	没有	0
纸买多大的呢？	看数字！	0
卖家发的什么快递啊？	还可以吧,发圆通	1
手机怎么样长时间卡不卡？	还不知道  刚买没多久   现在还没出现卡顿的情况	0
这款手机怎么样好用吗	还不错吧，电反正经用，信号网速都不错，但是不知道怎么回事，天一冷就不好划开屏幕，	1
实际可用运行内存有多少？	32	1
是5s吗？	我买的是5s	1
录像是有声音的吗？	有，也可以关掉	1
麻烦问下您，手机发热怎样？	还好吧，在好的手机重度使用都会热	1
相机怎么样	新的机子，像素很好，其他要做就有点挫了，毕竟不是智能机	1
你们不觉得小米max的屏幕黑边有点宽吗？	没有黑边，谢谢	1
想买个6p|大师门说说是翻新机吗？	不是，全新官换机	1
送镜头盖吗？	有的	1
是金属的吗,质感怎么样	是 质感不错	1
可以听歌吗？	可以	1
就是一开机有多少运行内存啊	用的是3个没用4g	0
听说机械革命是清华同方的？	去买联想吧，前怕狼后怕虎	0
可以作为主机用么，	我就是作为主机使用的，耗电量如果不停地玩的话，4个小时左右电就完了，我是手机重度使用者，但我能接受这个耗电量，手机偶尔会卡就和其他安卓机一样，总的来说，我用了几个月了，我觉得还是很不错的	1
插卡吗	我是用无线的  输WIFI密码	1
确定是新机吗，	这个我看不出来额	0
真的是行货吗？	是的	1
有用花呗的么，	有免息的	0
怎么没有手电筒啊	这个我也不清楚	0
这个手机连网咋样|	一般，信号不是太好，反应迟钝有点	1
D90能用不	能	1
屏幕分辨率是不是很差	瞒好	1
亲们，那个摄像头有没有很引人警惕，	可以	0
腾讯是山寨大王，这家是腾讯出来的，会不会一样山寨	我是朋友推荐的 手机用着很好 是正品 只是价格的问题	0
是不是正品手机？	我买的美版，正品，4.2寸，1280*768	1
花呗每月自动扣除吗	是的	1
玩守望先锋等开几档，	没玩过	0
还有同样的价格别家店比旗舰店的赠品丰厚很多，会不会手机有猫腻呢？	这个不太清楚	0
会翻车吗	什么是翻车	0
好用吗	我买的没啥质量问题，一切都很好，散热也比老款的强了一个档次，顺便说下，显卡和cpu都是焊死的不能换的	1
请问用过一段时间之后，指纹识别正常吗	目前没问题	1
这是正品吗？	我觉得是正品，那些码都一样	1
多少G运行？	不是2g	1
是正品吗，	是正品，用了一个多月了，还可以	1
请问买过的，这个手机有保修卡和说明书吗？	有，手机可以。充电会发热，使用倒不会。	1
64GB够用吗	我只玩玩游戏，听听歌，看看视频，不是发烧友，完全够用	1
怎么分期，	买的时候有选择分期或者不分期	1
能买吗？	去买联想吧，前怕狼后怕虎	1
能玩大型游戏吗，	暂时没发现有什么毛病，我是买回来灰色给我爸用的，说实话拿到手拆开就想跟我爸换手机了，不仅外观特别好看，还指纹解锁，3G运行内存  32G  还是全网通，真的想换了  我爸不干	0
电脑是不是假的	不是	1
爆炸范围有多远	大概可以把你炸上天	0
你们买的a59s的是固态home键吗	不过我见我同事买的金立M6.性价比更高。	0
好用吗？	还可以	1
64g实体店有卖吗	不知道喔我是网上看可以就买了	0
电池冲一次能用多久？	新的一样  电池损耗百分之10左右	0
这是智能手机不	不是	1
这款好用吗？	挺好用的，很简单，海边超级实用，周围人都投来羡慕的目光哈哈	1
为什么手机膜会在盒子里？	没有啊，盒子上两边的标贴都是未动的，可能手机膜是在出厂就放里的吧，	1
机子是翻新？	还好吧。	0
买了个美版的6S，开盒发现没有卡针，这正常吗？	认真找找啊，我买的里面有卡针的哦	1
屏幕暖屏么？	嗯额，还可以	1
评论都是这么多字的长篇大论，不是好评多少字返现吧？	不好用，别买	0
送内存卡|这款手机可以插内存卡吗	可以	1
有nfc功能嘛？	没有，	1
真的能连wifi吗	骗人的	1
发热不？	我看游戏直播感觉有点热 其他软件游戏用着还可以不热 电池正常使用一天一充 要是连续玩两三个小时游戏或看直播的话一天两充	1
有没有用坏了的？	还可以，没坏的	1
你们买的都不给手提包和鼠标吗？	给了啊，双肩包，不过是当初搞活动给的	1
真的可以买吗？	当然可以买啦，几十块钱。我妈在用没什么问题。	1
R9和X9有什么不同的，	我身边的朋友都在用 r9plus，都说蛮好的。	0
请问此手机是多少价位买的？	1259买的，当时搞活动，有优惠    现在用的还可以，挺不错的	1
差价这么大，值得购买吗	还好	1
买到手是不是客服说的6+128的，	反正我的修了一次没有修好给我，我又寄回去修了，现在都还在厂里	0
买过的亲们，请问wifi信号好吗，	不错，无线网杠杠的，一切都好	1
是全新的么？	嗯嗯！	1
高清清晰度在什么范围	百度或许会更好。高清720P，超高清1080P。都是指图像像素的清晰度而言，至于压缩或者解码后如何，不得而知。其实480P就已经可以的	1
可以战斗10年吗？	10年？哥们你想太多了吧	1
有木有可能卖的不是正品	没有查过。	0
能满足妹子的拍照像素需求吗？	像素不怎么样，如果爱自拍，就别买了	1
屏幕有没有红线	没问题，经常洗	1
这款是不是华为麦芒4正品	是正品，用着还可以，	1
而且反应也有些慢，怎么这么多问题	我的没有，那你去售后检测一下。	0
好用吗，	好用，不卡，	1
2400买的会是好的新的嘛	好	1
这手机1万人民币，有什么优点么	跟一般手机相比算是入门级彰显身份，跟7-8万，十几万的镶嵌钻石，镀金的相比。算是入门级的高端机	1
和实体店里一样吗？	嗯淘友如果你看上这款手机的话你就在这家买本人用时不卡也不发烫全网就他家价格实惠	1
可以作为主机用么，	我用了三个月了，感觉不错，耗电量可以接受，纯待机一天多没问题。正常使用一天没问题。	0
你们的max2指纹解锁正常不？	已经刷了miui8目前一切正常！	1
有自动开关机静音功能吗？	可以	1
请问买官方标配送屏幕贴膜吗	套餐里有	1
半副可以用吗	理论上说可以	1
这个是正货吗？	是的	1
有没有是翻新机的？	这问题还真不好回答 你不信的话大家怎么回答你都会觉得是托啊    反正型号Nk开头 激活后在官网查了还有350几天的保修 你自己判断吧	1
能甩地上吗，	可以砸核桃，你信吗？	1
自带office|吗？	嗯	1
质量好吗，	还行 最主要的是可以diy 但是拆机是个考验diy者	1
有没有发|票？	有发票，我用差不多一个月，老黑屏，闪屏，上网卡得很，经常死机。	1
是正版原装未开封未激活的吗，	可以保修	0
手机用着咋样	好用的	0
有用超过1个月的么	用了近一个月还沒发现问题	1
我就想问机子耐用吗？	滚开？你这种态度我反cnm？	0
帧数多少，	没试过，目测玩不了	0
请问wifi连的好吗？	没有。还行	1
手机卡吗？	指纹的 我的电信卡	1
note3和5哪个好？	不知道	0
跟w2015比选哪个啊	反正我用着不怎么好使。	0
送了书包质量如何，	没有	1
金色前面屏幕边是白色的吗？	是白的	1
到底是不是正品，	好用的	1
大家觉得手机怎么样？	我也是买半月了用着挺好的	0
有鼠标和鼠标垫吗？	没有	1
能升级系统吗？	可以升级，已更新最新。	1
这个电脑官网报价优惠完了6999|这家店卖这么便宜是正品吗是旧件重装吗值得信任吗	查了条码，出厂2个月左右的在保机器，，目前使用正常，，	1
和m3比|哪个性价比高？	性价比肯定是M3高，毕竟它该有的功能都有，而且也够便宜。	1
45%的色域广度和72%比起来有很大差异嘛？	微软不开源，所以如果不是正版系统很多定制化问题他们解决不了，色域45%算显色能力比较差的屏，72%的还行吧。	1
16g内存小的吗？	16g？？如果平時拍啊看電影下音樂什麼的，16g就小了。現在的手機最低也要3+32起步吧？？我覺得	1
可以自己插内存卡吗？	可以	1
腾讯是山寨大王，这家是腾讯出来的，会不会一样山寨	买了好几台了，暂时无问题	0
用来办公效果如何？	不会啊怎么会坏啊。。。	0
佳能M2能用吗	佳能与尼康的卡口不同，佳能机只能用佳能的卡口。	1
玩大型游戏久了会不会卡	目前用了一个月，没发现卡机，，，不过价格和实体店一样，，，	0
会不会很卡	不知道，给人家买的	0
卡不卡？	我帮别人买的，听说很不错	0
是不是闪充的	不是的	1
能删多少，	除了主要功能其他都可以删	1
玩游戏卡不卡，	为什么我的没有	0
会不会卡屏	王者飞快	1
咋样？	太垃圾了	1
是全网通，全4g的吗？	可以购买！性价比很高的一个手机	0
能用NFC吗？	可以	1
请问字体大吗？	字可以调大小的	1
下载东西麻烦吗	下载东西肯定不麻烦啊  点一下就好了 ！除非你要下载非法的  那就麻烦了！！	1
请问有正规发票吗	是电子发票	1
耗电量，和系统流畅度怎么样！	我用了三个月了，感觉不错，耗电量可以接受，纯待机一天多没问题。正常使用一天没问题。	1
请问曲面容易误触吗	不会	1
容易发热吗。	像素就平常这样，玩王者1个小时轻微发热，充电1个半小时左右	1
前置摄像头拍照怎么样	正常使用没问题。不过后置的都非常凑合，前置的自然也一般。这款手机就不是主打拍照的。	1
是不是拍了就秒洗出？	是的	1
亲们，能不能插移动的卡。	能	1
主要电池耐用吗？	没问题的，9系统不敢升级	1
现在销售的黑边改了吗	没有 定型的版本哪有那么容易改	1
核实手机的信息从管网的哪里找？	查序列号就行	1
真有广告说的好？	现在手机除了苹果系统，使用起来都差不多，买这个M2017送我爸，反正他特别喜欢，他觉得特别有面子，有钱难买爸高兴，哈哈。因为不在他身边，不知道用起来怎么样，但是信号真的比以前那个手机好多了，我家信号不太好，用了这个打电话不用喂喂喂了，这点最重要。也对比过其他，其他品牌都跟苹果长的差不多，三星又怕炸，我看这个M2017真皮的后盖，我觉得比较符合我爸气质，就爽快拿下了，发货也很快，金立还是很好哒	0
屏幕有没有红线	没下过水额～屏幕没问题的	1
朋友们！此款双卡双待手机用的是标准卡（大卡）吗？	是	1
请问一下各位老板，配件是原装的？	原装	1
能用cs1.6吗，	没玩过这几个游戏	0
会不会卡机	检测过是正品来的，到现在为止还没过	1
请问怎么切换4G的开关	不知道哦，送给老爸用的。	0
这个是6sp吗	是的	1
这个玩王者卡吗，	我不玩游戏 只是看看小说 看看电视剧 看个新闻啥的 自己觉得足够用咯	0
怎么解决	要关掉屏幕长亮按键，在手机设置里面	1
我想问一下，难道那么多人家里面家具都是一样的吗？	我买了就外出办公用，比较轻巧。玩玩小游戏也行	0
手机是新的吗	嗯	1
待机如何？	还好	1
系统会卡顿闪退吗？	刚买一个月，现在挺好的	1
请问是否支持快充？	三星从s5开始就是快充了呀！	1
手机用着咋样	好用！不卡！挺好的	0
卡吗	不卡	1
能用几年	不是电脑合不合适，是看配置说话。这配置挺好的	0
珠光白|的边框是银色的还是金色的？	不知道呢，我买的是金色的	0
质量如何，	没事不会摔手机玩呀  质量还行的！	1
按键机身会掉漆吗	不会，我妈那个用了两年了，让掉水里了，才重新给买的	1
网络好不好啊？	很好	1
请问你们用什么颜色好看些？	摩卡金+1	1
卡吗？	放心买啦！没问题的，我都帮我同事买了五部了!	0
前摄像头怎么样？	讲真 挺差	1
手机质量如何，	还不错~给老妈买的	1
手机是原装未拆封的吗？	我买的移动版，用着还行，玩大点的游戏卡，我玩的王者荣耀。感觉跟我499买的大神F1极速版差不多，那个是2G运存8G存储的。玩游戏建议CPU骁龙820的。这款包装看着是原封，但我用鲁大师验机不识别，跑分是跟原厂差不多。但绑定的乐视会员在官方没查到。	1
有没有a5100的妹子和我交流一下|	不知道为什么它文字的不让我发。补充一下，就是30mm镜头体积更大、较长，但我认为不影响～	0
送的耳机是什么样的	可以音质好	1
与魅族mx6和oppo|r9相比怎样	用着挺好的	0
来电铃声怎么设置呀？	很好用	0
我想问下，怎么把后盖打开上电池？	我也开了好久，不要看手机后盖那条黑色线条，是靠手机白色金属那条线开，	1
有收音机功能吗，	没有	1
努比亚有几个按键？	跟上边说的一样，手感外观都很舒服就是有时候信号不太好。功能比男朋友oppo功能还多点。	0
语音助手和实时翻译功能可以不联网使用吗	不是有有道和google吗	0
可以听歌吗？	不过声音小声一点	1
会不会有不灵敏或是按不动的感觉？	没有，感觉还可以！	1
值得买吗？	可以	1
我的手机里包装中没有防伪码。你们有吗？	在手机背后。	1
手机好用吗？	没问题的，9系统不敢升级	1
送钢化膜吗|	是贴好的单独还送了一个	1
套餐四得快不快？	快，静音。	1
麻烦问下您，手机发热怎样？	程序开多了，会热，只玩极速变色龙，玩一会就会热，平时内存使用都是1.5G到1.7G左右，谷歌的服务他都在开，root网上有教程，刷一下估计会好用，我没刷。	1
大家人，说真的，好不好用，	不玩大游戏，别点那么快，就不卡	0
来电，通话声音都怎么样买过的亲们麻烦告知一下真实情况，	就这样，可以！	1
正面是白色好看还是黑色？	个人喜欢为主，自己到实体店看看	0
屏幕尺寸多少？	我买的美版，正品，4.2寸，1280*768	1
遥控买不买好	随你，我都是手机恩的	0
请问你们用sd拓展了么？	电池很好啊，	0
电脑好用吗	可以啊	1
耐用吗，	1000元机要求不要太好！	0
容易碎屏吗，	不会碎，但是屏幕闪烁很严重，还没有想到好的解决办法	1
哪个套餐能玩cf	最高的配置	1
請問攝影影像清晰嗎？	一般，但是声音没杂音，没装麦克没试！	1
耗电吗？	便宜机马马虎虎。性价比高还是ZUK	0
请问亲们拉丝银白和拉丝深灰有何区别？	就是颜色不一样，其他都一样的，没啥差别	1
用来办公效果如何？	看人品和运气…	0
用起来流畅吗？	相当流畅，性价比高！关键华为质量还过硬！	1
为什么手机膜会在盒子里？	没有啊不清楚	0
是否是正品啊？	是正的，3天	1
亲们，是正品吗？	应该是正品用了半月没见毛病	1
女生|纠结买p9还是mate9...	挺大的女孩子拿有点大	0
想问的是，这会不会是翻新的	联想是看发票日期的一年内质保，所以即使翻新1年内出了问题都是免费修的	0
g4400加960m玩GTA5可以开中高吗？	可以开中不卡	1
联通3G的可不可以用啊	4G都可以	1
发烫之后是不是会卡？	不会	1
一般充一次电，也不怎么玩，大概能用多久？	一天左右	1
会坏吗	废话	1
能用几年	这个怎么说的清楚	0
这个不升级能用电信卡吗	可以	1
这个机子还有没有停产，夜景拍得怎么样？	拍夜景很ok早停产了	1
可以换字体吗	给我老婆买的 她说用着蛮好的 每个手机都可以换字体。	1
玩王者荣耀卡吗？	不好意思，没改	0
如何解决？	这个应该是手机问题	0
Nex-5可以用？	你问问卖家，有符合你相机的转换头，我的5000	1
听说红米4通话信号和wifi有问题？你们出现过吗？	我暂时遇到的问题就是通话质量不好和摄像头发暗，小退键不灵敏	1
内存大吗这个	不是很清楚，买给老人用的！够用	0
信号好不？	非常好    我一直用的都是小米	1
这家店和旗舰店一样吗？	一样的货，没问题	1
与1770c比推荐用哪个？	还是17-50 恒定大光圈加os防抖	1
7p充满电要几个小时	4个小时左右……	1
a7M2，和a6500哪个更好一些？	两个相机不是一个档次，还是看你的需要，如果经济宽裕还是A7Rll配G镜头。	0
请问移动卡可以吗	全网通的！手机对得起这个价位！玩王者荣耀也不卡	1
lol中效可以么	三个都没问题 如果硬要说最好的话 7570吧	1
充电从0%～100%要多长时间	充电快，需要50分钟	1
能用cad.ps吗？	我没用 ，不过应该能用，不会速度很快就是了	1
手机自带美颜功能吗	有，不怎么好用	1
相纸十张能用多久啊	十张照片	1
请问一下|是不是组装机	这个我就不知道了，反正用得挺好的	0
带出国能装google|map么	应该可以吧～	1
怎么样分期呀！	大于600就可以分期	1
确定不是翻新机吗	不是	1
建议购买吗	日版性价比非常高！值得入手！加超雪卡贴都可以啊！不错	1
屏幕真的不怎么样吗？	45色域ips屏，总比那一堆垃圾tn屏好，就是生产商不是lg，是京东方而已	1
lol中效可以么	可以，HD4000中高特效稳定八九十fps	1
请问9s怎么分别设置两张电话卡的来电铃声	不知道	0
有烧主板，卡在开机Logo进不了系统的吗？	我的暂时没发现	1
手机是真的还是假的？	服务可以的啊	0
这是不是山寨机？	绝对正版，运行流畅，简洁，玩手游cf无压力，续航目前待机一上午只用20分钟还是满格电，玩cf游戏估计能玩个6小时都没问题，发热明显，但不是非常烫手那种，能感觉的出来，轻微的！相机功能一般，本人不爱自拍，这点忽略！总结:续航，游戏，流畅，简洁！	1
有用了两三个星期的淘友嘛，	我还没用过指纹解锁	0
玩王者荣耀卡吗？	不知道，没下那游戏，给家人用的	0
移动版的打王者会卡吗	打游戏有些吃力 买3g缓存的吧	1
又想出的么	出白色99新哈	1
五千二那款开守望高配置会卡吗	我开剑灵四档还是很流畅的	1
有6G+128G配置的吗？	有货就有啊 我就是行政版的	1
华为mete9pro和华为mete9保时捷有什么区别	就是一个标签	1
送钢化膜吗|	已经贴好的，还多送一片	1
这个手机可以用几天充电	我看电视小游戏基本就是用一天多，不玩游戏不看电视我可以用两天	1
套餐三怎么样？	还好吧。	1
玩久了会不会发烫？	不会	1
会不会用上三五个月就坏掉？	不知道会不会，经常会出现运行内存已使用99％,不知道什么问题	0
写入速度大概多少？	很快   很好	0
这个显示屏长和宽各是多少厘米，	29.5*17	1
自拍有没有美妆功能	有	1
有的软件下载不了？	是的	1
这款手机插内存卡是不是存不上去吗？	可以的	1
待机多久呢？	我一般三个多小时。	1
能甩地上吗，	这个问题问的我无语回答，只想说它不是铁	1
跑焦严重吗？	跑焦跑得挺厉害，网上租了个底座调好了	1
是塑料外壳吗？	蓝色外壳当然是塑料	1
这个笔记本有没有带WIFI？	有	1
求问玩剑网三开全效会卡么？	反正我买的正版侠盗飞车5不卡，那是我见过最大的游戏了	0
有一段时间不卡吗？	到手后一直都在游戏，一天没问题   充电半小时轻松续航一天	0
像素和诺基亚1020有的比吗？	前置1600W后置1300W	0
新手第一次接触|应该买什么套餐	18-55的套机吧，各方面都友好些	1
遮个办公用没有问题吧	我没用这个加了钱换了个没试过但是2800的还真可以挺快的	0
会不会出现内置软件乱收费情况呢？	这个手机不建议你买，我买完就后悔了	0
手机收到，为什么开不开机，	还没用了	0
有多少人买了情况怎样？	手感没得说，但是感觉电池没有想象中那么耐用	1
电池耐用吗。	是全新的。电池耐用。个人观点。	1
我买的怎么会没有原装包装盒？	我的没发现螺丝动过。	0
手机用时间长了|卡吗|	不卡，反正我用着挺好用的	1
有人感觉手机是二手的吗？	都说是黄牛货了，翻新机没那么快	1
问下充电器插头是港版制式那种大大的很粗那种插脚还是大陆那种扁扁的插脚？	扁的	1
珠光白|的边框是银色的还是金色的？	白色	1
屏幕是多少寸的	15.6性价比可以，有钱弄个i7处理器	1
只能安电信卡吗	是的	1
有送其他的东西嘛？	挺好的	0
为什么买不到几个月，指纹键就不能用了，	可以去售后换	0
好吗？	挺好的，我用的不错，物有所值	1
我是8月17购买的，之前开机也显示中国移动有个4G标志，现在变2G了，怎么回事啊	还有你手机上面的4G开关有没有打开？	1
国行？	有	0
电池耐用吗，	电池没问题，指纹灵敏，音质不错	1
和实体店里一样吗？	实体店的我不知道，没去看过，但是这家店的绝对不差，我买给我妈用，她很喜欢	0
带几块电池呀	两块，但质量是真不好。收到的手机充电越充越少。充不进去电。去修手机说是翻新机。还能看见很多焊点。	1
是64G的吗？	有32G的和64G的	1
能不能触碰？	不能	1
请问现在的新款战神系列笔记本电脑还支持安装|Win|7|系统吗？	预装是w10，有特殊需求跟店家商量吧	0
充电多久	像素就平常这样，玩王者1个小时轻微发热，充电1个半小时左右	1
质量可以吗？	质量还行，就是守护宝不好用	1
玩王者卡吗。	配置是完美运行的，关键网络稳不稳定	1
mini8拍出来清晰吗	清晰度还是可以的，毕竟是化学成像，但是因为是闪光灯，所以阴影会挺严重的，一定选好角度	1
是随机发放的系统吗	可以自己选择比较低版本的系统，8点几的系统	1
这手机插卡就可以用吗？	是的	1
这个质量好不好啊，	可以用，对细节要求比较高的话还是考虑其他的吧。	1
能下载2GB的游戏吗	游戏我没下过没试过手机游戏我不玩只玩电脑游戏 在这个价格就是可以了 只有电池不耐用	0
请问买过的，这个手机有保修卡和说明书吗？	有	1
买过的朋友说说这个机子好用吗？	我买回来拿去实体店请朋友验过，是正品，机子也很好用。值得购买，但是电子产品买还讲运气^_^	1
我怎么刚买了前置摄像头拍照不是模糊是根本什么都拍不清	可能有问题！手机不是很好	1
手机像素怎么样？	不错，很给力。真的好用	1
手机是全新未开封的吗	对的～现在也在用，完全没问题啊～	1
为什么这不便宜？	正品，开机八秒	0
电池才3000毫安，续航是不是很差，	上网，不停使用，12小时总能撑到的。这里普通使用，两天充一次电，新机子电池总归能用很久，时间久了就不定了，要续航你不如买个厉害的充电宝，爱用多久用多久。	1
这手机能瞬间抓拍吗？	能，只不过虚焦了……	1
这款手机到底好不好	用了1个多月了，还不错	1
360N4A这款是正品吗？	是正品吧，这个倒是没多大在意，就是偶尔会卡顿，像素不好，电池消耗快，不过屏幕蛮大的打游戏非常不错	1
买笔记本电脑送不送鼠标垫啊？	没有鼠标垫 毛线都没送。。。	1
和|iPhone|7哪个好	其实得分 你习惯了什么系统，各有所长	0
是正品吗？	是的很好用	1
可以做安卓开发吗，	晓不得，只是常规学习娱乐用。没装双系统	0
畫質好嗎？	一般，但是声音没杂音，没装麦克没试！	1
可以想智能手机一样点吗和手写吗	行，没问题的	1
屏幕边缘有缝隙吗	边上一圈泥	0
适合有点耳背的老人用吗	智能机音量都不大.建议买功能机	1
有人买黑金色吗？	好像没有黑色的，这款机器一般，要买的话慎重，推荐联想有一款。	1
没有度数可以在里面戴隐形眼镜么|	没有	0
什么系统啊	WIN10	1
骁龙821四核和骁龙625八核哪个强	821	1
耗电不	是正品，使用正常。	1
感觉怎么样？	感觉不错	1
这家电脑好用吗	还可以，买给女朋友办公用的	1
电脑很卡吗	看你怎么用，	0
不是托的美女帅哥们，这个手机真的怎么样？	我买给女朋友暂时过度，她原先实体店买的6s.被偷了，她说电池不耐用，其他还行吧	1
请问是64G还是64GB谢谢	去正规的店去买，网上不靠谱。	0
有木有可能卖的不是正品	我没查过，怎么查？？   我也试试	0
是正品吗	是一样的	0
CF和英雄联盟特效全开会卡吗？	兄弟 gta5都不卡 这俩破游戏能卡么？	1
为什么有50元的价格差	颜色不一样而已	0
核实手机的信息从管网的哪里找？	序列号查询	1
会不会是翻新机啊？	应该不是翻新机 你可以去网上查的	1
运存多少	2G	1
R9和X9有什么不同的，	我觉得r9splus用着还可以！x9没用过，也没朋友在用！	0
主要电池耐用吗？	没有问题	1
或者是用的时候有什么问题吗	一样够用，不说50/1.4，就是50/1.8都挺不错	0
各位，用着怎么样？	不错，店家很好人，有什么不懂都可以问	1
亲们，手机有问题吗？	目前没有	1
紫色是陶瓷机身的么	不知道	0
请问是怎么装储存卡的	不知道，连后盖都打不开。	1
网络怎么样？	还行，三G哦	1
手机像素|怎么样？	还行	1
用这感觉性能各方面还好吗	感觉还可以	1
还有是否能玩《gta5》？	可以玩，但肯定比台式机差	1
平时不怎么用相机的，容易学会吗？	还不错。调个色，成品自己看吧	0
什么时候有黑色的呀	好难得，要不买5S或者5 puls	0
请问美颜效果如何？	特别棒	1
按键有没有不灵，	我用了没什么问题	1
买了有什么不满意的吗？	还好吧，还没感觉到有问题	1
这个电脑可以读取光碟吗	可以，必须加固态，删掉自带的东西，不然卡死	1
套餐三怎么样？	不知道。反正都那样当备用机可以的	0
我主要是给3岁的女儿拍照片，偶尔拍风景，35和50哪个好用，	35用途相对广些 50感觉只适合人像	1
请问只用来打电话可以吗？	能听清特别棒	0
这个显示屏长和宽各是多少厘米，	29.5*17	1
和索尼a6300比哪个好	用起来还是很不错的，前几天出国玩拍出来了不少好片	0
和oppo,vivo,华为小米比怎么样？	配置应该是最高的了，关键要看处理器配置。oppo和vivo和这个没法比。自己百度一下这几款的配置就知道了。不过自拍狂就不要买这款了，毕竟前置摄像头400万像素。其他方面胜过多数旗舰手机。	1
电耐用吗？	这个价格追求实惠吧。。这手机什么都好，就是无线连接有问题，时常密码要重输，搞的人烦死了	1
店家W号多少？	KINBOOK 我加的是这个 你可以问下客服	1
你们注册“我我的尼康”是用手机注册的吗	我在电脑上注册的  晚上那个尼康中文登录不上去，手机也可以注册	1
上网可以几个小时呢？	还好吧，一天还是没问题的	1
这款手机屏幕是不是不好啊，	这个情况倒是没有，手机使用目前正常，买了有差不多1个月了吧	1
我刚买了一部，网页是6G，收货打开是4G，是咋回事	有，运存在开机后下方显示	0
我怎么刚买了前置摄像头拍照不是模糊是根本什么都拍不清	你的呢个可能有问题   我的前摄像头白天拍可以    晚上就模糊的很	1
有游戏么	有	1
3000多买这手机，合算吗？	魅族系统用习惯了，个人觉得一般吧，	1
主看电影|分辨率会不会有点低	我是买来在学校用的，平常会用到办公软件，ps和追剧，散热还行，店家送了散热垫，看一下午的剧也不是很热，分辨率也还可以啊，我没什么太大的要求。偶尔玩低效lol也行，性价比还算高	1
这台电脑厚重么|	不厚不重刚刚好	1
手机是不是翻新的，	系统内存多不多无所谓  主要是手机真的不咋地  千万别买  否则会后悔	0
送人的话怎么样啊	是全新的    送我呗	0
能换壁纸吗？	可以，女儿就是上网下一个换了。	1
多少英寸	和5S外观一模一样。	0
双4G是什么意思？	可以用联通和移动4G不可以用电信，还不如买全网通	1
值得入手吗	手机质量真的没话说	0
可爱红还是粉红色那个好看啊？	粉色的好看	1
&zwj;摸着良心说话，这手机是不是真的？	说真的，反正我收到的是真的也没问题	1
会不会用了几个月就开始卡	升级系统，重置手机，按时清理垃圾	0
这个用来拍球赛的效果怎么样？	买来主要是拍水下的	0
请问你们安联通卡怎么设置的	客服会告诉你的	0
请问这个手机是原装未拆封的吗？	是正品	0
你们购买的外包装有封膜吗？	有的，机子用着还行，就是信号相对较弱。	1
灰色3399是真的吗？	我的一个礼拜就到货了	0
手机像素|怎么样？	可以	1
送内存卡|这款手机可以插内存卡吗	可以，内存卡和卡2是同一卡槽	1
